Xoc, Xoc, Xoa^Efs, Xoa, Xoa, Xoc, Xoa, Xoa, Xot, Xoc, Xoc, Xoc, Xoc, Xoc, Xoc^Efs, Xur, Xor, Isa, Isa^Em, Xor, Xor, Xoc, Xor, Xor, Isa^Dr, Isa
Xoa, Xoa, Isa, Isa^Dr, Tb, Xoa, Isa^Dr, Tb, Isa^Em, Xot, Xot, Xoc, Xoc, Xoc, Isr^Qhh, Isr^Qhh, Isa^Dr, Xor, Xoc, Isa^Dr, Isa^Pr/, Xoc^Efs, Isa^Pr\, Isa^Dr, Isr, Isa
Xoa, Isa, Isa, Isa, Isa, Isa, Isa^Ebn, Xoa, Isa, Isa^Em, Isa^Dr, Xot, Xot, Isa^Qhh, Isr, Isa^Qhu, Isa^Qhu, Isa^Em, Xoc, Xoc, Isr^Pr\, Isr^Es, Isa^Em, Isa^Pr\o, Xoc, Xur
Xoa, Xoa, Tb, Isa, Isa^Ebn, Isa^Qhh, Isr^Qhh, Isa^Em, Isa^Ebn, Xoa, Isa^Dr, Isa^Dr, Tb, Xoa, Xoa, Isa^Es, Xoc, Isr^Pr/, Isr^Es, Isa^Es, Isr^Es, Isr^Pr\, Xor, Isr^Pr/o, Qxe, Xoc
Xoa, Tb, Isa^Dr, Xoa, Tb^Em, Isa^Em, Isa^Eb, Isa^Qhh, Isr^Qhh, Isa, Isa^Eb, Xoa, Isa^Qhh, Isr^Qhh, Xor, Xor, Isa^Es, Isr^Pr\o, Xoa^Efs, Isr^Eb, Isr^Eb, Tb, Qxe, Xor, Xoc, Tb
Xoc, Xoa, Xoa, Isa, Tb^Em, Xoa, Isa^Dr, Tb, Isa^Ebn, Isa^Qhh, Isr^Qhh, Isa^Qhh, Xoc, Xoc, Isa^Em, Isa^Dr, Isa^Qhu, Isr^Es, Isa^Em, Xoa, Isr^Pr\o, Isa^Es, Tb^Pr/o, Xoc, Xor, Xoc
Xoc, Xoc, Xoa^Efs, Xoa, Xur, Isa, Isa^Dr, Xoa, Isr^Qhh, Isa^Qhh, Xoc, Isr^Pr/o, Isa^Em, Isr^Es, Isa^Qhu, Isa^Qhu, Isa^Qhu, Isa^Qhu, Isa^Em, Isr^Es, Xoc, Xoc, Isa^Em, Isa^Es, Isa^Pr/, Xor
Xoa, Xur, Isa^Qhu, Isa^Qhu, Isa^Qhu, Xoa, Isa^Qhh, Isa^Qhh, Xor, Xoc, Qxu, Xor, Xor, Isr^Es, Uu^Vud, Isa^Qhu, Isa^Em, Isr^Es, Xoc^Efs, Xoc^Efs, Isa^Es, Isa^Pr\o, Xur, Xoc, Xoc, Isa
Xoa, Isa^Qhu, Isa^Qhu, Isa^Qhu, Isa^Es, Isa^Dr, Xoc, Xor, Isa^Dr, Qxe, Xoa^Efs, Isa^Dr, Isa^Dr, Xor, Xoc, Isr^Es, Xor, Xor, Isa^Em, Isa^Em, Isa^Qhu, Isa^Qhu, Isa^Qhu, Xor, Xur, Xoc
Xoc, Xoa, Xoa, Uu^Vud, Xor, Isa^Pr/o, Isa^Em, Isa^Pr\o, Xoa, Isa^Em, Isa^Em, Isa^Vud, Isa^Em, Isa^Em, Isa^Es, Xoc, Isa^Pr\o, Isa^Dr, Xot, Isa^Qhu, Isa^Qhu, Isa^Vud, Isa^Qhu, Isa^Qhu, Isa^Em, Xoc
Xoc, Xoc, Xoc^Efs, Xor, Isa^Dr, Isa^Pr\, Xoa, Isa^Pr/, Isa, Xoc, Xoc, Isa^Es, Isa^Em, Xoa^Efs, Isa^Em, Isa, Xot, Xot, Isa^Qhh, Xoc^Efs, Xot, Isa^Qhu, Isa^Es, Isa^Es, Xoc, Xoc
Xoc, Xoc, Qxu, Isa, Xoa, Isa^Pr/, Isa^Dr, Xoc, Xoc, Xoc, Isa, Isa^Pr\o, Xoc, Isa^Es, Xot, Xot, Isr^Es, Isa^Qhh, Isa^Qhh, Isa^Qhh, Isa^Qhh, Xot, Isa^Em, Xoc, Isa^Em, Isr
Isa, Tb, Xoa, Tb^Pr/o, Isa, Xoc, Xor, Xoc, Isa^Em, Isa^Pr\o, Xoc, Isa^Pr/o, Isa^Em, Xoc, Xoc, Isr^Dr, Isr^Es, Isa^Vud, Isr^Es, Isa^Qhh, Xor, Xot, Isa, Xoc, Xor, Isr^Es
Xoc, Isa^Pr/, Isa^Dr, Xoc, Xoc^Efs, Xur, Isa^Dr, Isa^Pr\o, Xoc, Xoc, Xor, Xoc^Efs, Isa^Em, Isa^Es, Xor, Xoc, Isr^Pr\o, Isa^Em, Xoc^Efs, Xor, Isa^Dr, Isa^Es, Xoc, Xor, Isa^Dr, Isa
Xoc, Xoc, Xoc, Xoc, Isa^Qhh, Isr^Qhh, Isr^Qhh, Isa^Vud, Isa, Xor, Isa^Vud, Isa^Es, Xoc, Xor, Isa^Pr\o, Isa^Dr, Xoc, Xoc, Tb, Isa^Em, Isa^Es, Xoc, Xoc, Isa^Dr, Isa^Em, Isr^Es
Xoc, Xoc, Isa^Em, Isr^Qhh, Isr^Qhh, Isa^Qhh, Isa^Qhh, Isr^Qhh, Xoc, Xoc, Xoc, Isa^Pr/o, Isa^Em, Isa^Es, Isa^Es, Xoc, Xor, Qxe, Qxe, Isa^Em, Isa^Es, Isa^Vud, Xoc, Xoc, Isr^Pr\, Isa^Es
Xoc, Xoc, Xoc, Isa^Es, Isa^Em, Isr^Qhh, Xoc^Efs, Xoc^Efs, Isa^Dr, Xor, Xor, Isa, Isa^Em, Xoa^Efs, Xoa^Efs, Isa^Em, Isa^Dr, Xor, Xoc, Tb, Xoc^Efs, Isa^Pr/o, Isa^Em, Isa^Es, Xoc, Xoc
Xoc, Xoc, Isa^Em, Isa^Pr\o, Xor, Xor, Isa^Es, Isa^Em, Isa^Eb, Isa^Dr, Isa^Pr/o, Xoc, Xur, Isa^Es, Isa^Em, Xoa, Isa^Em, Isa^Dr, Xoc, Xoc^Efs, Isa^Em, Isa^Es, Xor, Xoc, Xoc, Xoc
Xoc, Xoc, Isa^Es, Xoc, Xoc, Isa^Dr, Isa^Em, Isa^Eb, Xoa, Xoa^Efs, Isr^Qhu, Isa^Es, Isa, Xor, Xor, Isa^Es, Xoc, Isa^Pr/o, Isa^Es, Isa^Es, Isa^Qhu, Isa^Qhu, Isa^Qhu, Xor, Xoc, Xoc
Xoc, Xoc, Isa^Pr/o, Isa^Pr/o, Isa^Es, Xor, Xur, Isa^Pr/o, Isa^Es, Isa^Qhu, Isr^Qhu, Isa^Qhu, Isr^Qhu, Isa^Dr, Isa^Pr/o, Xoc, Xoc^Efs, Isa^Vud, Isa^Pr/, Xoc, Xoc, Isa^Qhu, Isa^Qhu, Isa^Qhu, Isa, Xoc
Xoc, Xoc, Isa^Em, Isa^Em, Isa^Es, Isa^Dr, Isa^Dr, Xoc, Isa^Pr\o, Isa^Em, Isa^Em, Isa^Qhu, Xoc^Efs, Xoc, Isa, Qxu, Qxe, Xoc, Xoc, Isa, Xoc, Xoc, Isa^Pr\o, Isa, Xoc, Xoc
Isa, Isa^Pr\, Xoa, Isa^Dr, Isa^Em, Isa^Dr, Isa^Em, Isa^Es, Isa^Vud, Xoc, Xoc, Xoc, Isa, Isa, Isa^Qhu, Tb, Tb, Isa^Dr, Xor^Efs, Xor, Isa^Es, Isa^Pr\o, Xor, Xoc, Xoc, Xoc
Xoa, Xoa, Isa, Isa^Pr\, Xoa, Isa^Es, Isa^Em, Isa^Dr, Xoc^Efs, Xur, Xor, Isa^Vud, Isa, Isa^Qhu, Isa, Isa, Xoc, Xoc, Isa^Em, Isa^Dr, Isr^Es, Isa^Es, Isa^Dr, Xor^Efs, Xoc, Xoc
Xoc, Xoa, Xoa, Xoa, Isa, Isa^Pr\, Xoc, Xoc, Isr^Es, Isr^Dr, Isr, Isa^Pr\o, Xoc, Isa, Xoc, Isa^Pr/o, Isa^Es, Isa^Pr\o, Xoc, Isa^Em, Isa^Dr, Isr^Es, Isa^Es, Isa^Dr, Isa^Pr/o, Xoc
Xoc, Xoc, Xoc, Xoa, Xoa, Xoa, Xoc, Isr^Dr, Wog, Wog, Wog, Isr^Es, Xoc, Xur, Xoc, Xur, Xur, Xur, Xoc, Xur, Xur, Isa^Em, Xoc, Xoc, Xoc, Isa
Xoc, Xoc, Xoc, Xoc, Xoc, Xoc, Xoc, Xoc, Xoc, Xoc, Xoc, Xoc, Xoc, Xoc, Xoc, Xoc, Xoc, Xoc, Xoc, Xoc, Xoc, Xoc, Xoc, Xoc, Xoc, Xoc
