Wo, Wo, Ww^Wkf, Ww^Wkf, Ds, Gd, Gs^Ft, Gs^Ft, Hh^Ft, Gs^Ft, Rd, Gd^Efm, Gd^Efm, Gd^Efm, Re, Re, Gd, Gd, Ds, Ds, Dd, Gs^Qhh, Re^Qhh, Hh^Qhh, Gd^Qhh, Hh, Hh, Gg, Gs^Fms, Gs^Fp, Gs^Ftp, Ss, Ww^Wkf, Ss, Ss, Ss, Sm, Ss, Ss, Ss
Wo, 1 Ww, Ww, Ds^Ewsh, Gg, Gg, Gs^Ft, Hh^Ft, Hh^Ft, Hh^Ft, Re, Re, Re, Re, Gs^Efm, Gd, Gd, Gd^Efm, Gd, Dd^Ewsh, Ds^Edpp, Gd, Gd^Qhh, Re^Qhh, Gd^Qhh, Hhd, Re, Gs^Fp, Gd^Fms, Gs^Ft, Gs^Fms, Gs^Ftp, Ss, Ss^Em, Rb^Em, Ww, Chw, Ss^Em, Ss^Em, Ss
Ww, Ww, Ds, Ds, Chr, Gs^Ft, Rd, Rd, Rr, Rr, Gs, Gs, Gg, Gs, Gd, Hhd, Ds, Gs, Gd^Fts, Gd, Ds, Gd, Gd^Efm, Re, Re, Hhd, Gd, Gd^Efm, Gs^Em, Gs^Fms, Rb^Em, Ss, Ww^Ewl, Wwf, Ww^Wkf, Ss^Dr, 3 Khw, Ss^Dr, Wwf, Ss
Ww^Wkf, Ds, Gs, Chr, Khr, Chr, Rr, Rr, Re^Vht, Rr, Re, Hh^Fts, Gll^Fts, Gll^Fts, Gd, Dd, Ds, Gg^Efm, Gd, Gs^Es, Gs, Gd^Qhh, Gd^Qhh, Gd, Hhd, Re, Re^Dr, Md, Hh^Ft, Gg^Efm, Rb^Em, Ww, Sm, Ss, Rp, Chw^Ewl, Chw^Ewl, Chw^Dr, Sm, Ww^Ewf
Ds, Ds^Ewsh, Gll^Fts, Chr, Chr, Chr, Rr, Gs, Gs^Gvs, Gg, Gll^Fts, Rr, Rr, Gg, Gg^Em, Gd, Dd^Dc, Dd^Edpp, Hhd, Gs^Efm, Gd, Gg^Qhhf, Gs^Fms, Gd, Hh^Es, Hh, Md, Hh^Vhh, Hh^Fds, Md, Md, Wwf, Gs^Ftp, Rp^Vhs, Ss, Rp, Ss, Ss^Em, Sm^Em, Ww^Wkf
Hh, Gll^Fts, Gll^Fts, Gll, Gll, Gs^Efm, Rr, Re^Vht, Gs, Gg^Gvs, Hh^Fts, Gll^Fts, Gd, Re, Re, Hhd, Gs^Es, Ds, Gd, Dd, Ww^Wkf, Gs^Fms, Gg^Fet, Hhd, Hh^Fds, Md^Fds, Md^Fds, Md, Hh, Md, Md, Wwf^Wkf, Ss, Gs^Ftp, Ww^Wkf, Ww^Bw|r, Ww, Sm, Sm^Em, Ss
Hh, Hh^Ft, Gg^Gvs, Gg^Efm, Gll^Fts, Gd, Rr, Gs, Gs, Hh^Fts, Gd^Fts, Gs, Gd, Ds^Edpp, Rr, Hh, Gg, Gd, Hh, Wwrt, Gd, Gd, Gg^Efm, Hh, Ww^Ewl, Wo^Wkf, Wwrt, Ww^Wkf, Gg, Hh^Fds, Gg^Fds, Md, Hh^Es, Gs^Ftp, Ww^Bw/r, Rp, Ss, Ss^Em, Ww^Ewf, Sm
Gs^Eff, Gll^Fts, Rr^Vht, Gs^Gvs, Rr, Rr, Gs, Gg, Gll^Fts, Gs, Gs, Gs^Efm, Ds, Dd, Re, Gg, Re, Gd^Fts, Wo, Ww^Ewf, Ss, Gs^Fms, Ss, Ww, Gs^Fms, Ss, Gg, Ww^Bw/r, Hh^Fds, Hh^Fds, Mm, Hh, Gg, Rp, Ww, Ww, Ss, Sm, Sm^Em, Ss
Gs^Eff, Gs^Eff, Re, Rr, Re, Rr, Gs^Wm, Hh^Fts, Gll^Fts, Ds, Gs^Efm, Gd, Ds, Hhd, Ds, Re, Ds, Re, Rr, Re, Re, Hh, Re, Ww^Ewf, Wo^Bw/r, Gd, Wo, Ww^Wkf, Hh^Fds, Mm^Fds, Mm^Fds, Mm, Hh^Es, Ww^Ewl, Wo, Ww^Wkf, Sm, Ww^Wkf, Ss, Ss
Re, Rr, Rr, Re, Ww, Rr, Gs, Gs, Gs, Gs^Es, Gd, Gd, Hhd, Hhd, Re, Re, Gd^Efm, Gd, Gd^Fts, Hhd, Gs^Em, Re, Rr, Ww^Bw/r, Wwrt, Ww^Wkf, Hh, Ww^Ewf, Ss, Hh^Es, Ss, Hh^Fds, Ww^Ewf, Wo, Gll, Ww^Wkf, Ss, Ss^Em, Ss, Ss
Rr, Re, Gll^Ft, Gll^Ft, Re^Efm, Re, Gs, Gll^Fts, Gg, Gs, Hh, Ds, Gd, Gd, Re^Vht, Ds, Wo, Ds, Ds, Dd, Gd^Gvs, Gs^Efm, Rr^Vo, Rr, Rr, Ww, Hhd^Ebn, Hh, Ss^Es, Ww^Ewl, Gs^Fp, Ww, Ss, Gd, Gg, Gs^Fms, Gs^Fms, Ss, Gll, Ss
Re, Re, Gll^Ft, Re^Vht, Gg, Gs, Ss, Gg^Efm, Gs, Gs, Gg, Ds, Gd, Ds, Re, Ww^Wkf, Hhd, Dd, Dd^Dc, Ds^Edpp, Dd, Dd, Gd, Gg, Hh, Ww^Bw\r, Rr, Gs^Fp, Gs^Fp, Re, Gg^Em, Ss, Re, Re, Rr, Gs^Fp, Re, Gll^Fp, Gg^Efm, Hh
Gs^Ft, Gll^Ft, Gll^Ft, Gs, Ss, Hh^Ft, Ss^Em, Gs^Efm, Gs, Gll^Fts, Gg, Gd^Fts, Gs^Efm, Gd, Re, Gd, Gd, Ds, Dd, Ds, Ds, Gd, Gs, Gg, Ww^Ewf, Ww, Rr^Vhcr, Rr, Re, Re, Rr, Rr, Rr^Vhcr, Gg^Gvs, Gs^Gvs, Re, Gg^Efm, Re, Re, Re
Dd, Ds, Gs^Ft, Ss^Em, Gll^Ft, Gll^Ft, Gg, Gg, Gg, Gg, Wwf, Gg, Gg, Gll^Fts, Gll^Ft, Re, Re, Ds^Edpp, Ds, Dd, Ds, Gd, Gd^Fts, Gg^Efm, Hh, Wo, Ss^Em, Gg^Es, Hh, Hh, Wwf^Es, Re, Re^Eff, Re^Eff, Re^Eff, Gs^Fp, Gs^Fp, Hh, Gg^Em, Gg
Ss, Ds, Ss, Ss, Gll^Ft, Ss, Ww^Bw|r, Ds, Ds, Ss, Wo, Ds, Dd, Gll^Ft, Ds^Edpp, Gll^Fts, Re, Gd, Gd, Hhd, Hh, Ww, Wo^Ewf, Ww^Ewl, Gg^Efm, Ww^Wkf, Ss, Gg^Gvs, Gs^Fms, Hh^Fp, Rr, Re, Gs^Fms, Re^Eff, Gd, Gs^Fp, Gg, Gs^Es, Gs^Fp, Hh
Wo, Ss, Ss, Ds^Ewsh, Dd, Ds, Wwrt, Ww^Ewl, Chw^Ewl, Ss^Em, Sm^Em, Ww, Wwf, Ds, Dd^Edpp, Gll^Ft, Gs^Fts, Re^Es, Gs^Es, Gs^Efm, Hh, Ds, Gg, Gd, Gg, Ss^Em, Wo^Ewf, Ss, Hh^Fp, Gs^Fms, Rr, Hh^Fms, Gg^Efm, Gg^Qhh, Hh^Qhh, Gg^Qhh, Gs^Qhh, Hh, Gll^Fms, Hh
Ww, Ww^Ewl, Wo, Wo^Wkf, Ww, Ww, Re, Ww^Wkf, Wwf, Ss, Ss^Em, Sm^Efm, Ds^Edpp, Ds, Gg^Efm, Gs^Ft, Re, Re, Gs, Gll^Fts, Gs^Ft, Gg, Gg, Gd, Wwf^Es, Re, Ww^Bw\r, Gg, Gs^Efm, Gs, Re, Rr, Rr, Gs, Co, Gs^Fms, Hh^Qhh, Gs^Fms, Gs^Fms, Hh
Ss, Ww^Wkf, Wwf, Wwrt, Ww, Chw^Ewl, Rb, Wo^Wkf, Ww, Dd, Ds^Ewsh, Ss, Ds, Ds, Gg, Re^Vht, Ds^Edpp, Ds, Gs^Edpp, Hh^Fts, Gll^Fts, Gg, Gs^Fp, Gll^Fp, Gs^Fp, Wwf^Em, Re, Gd, Re^Eff, Re^Eff, Rr^Eff, Rr^Vhcr, Gs, Ce, 4 Ko, Hh^Fp, Gs^Fds, Gs^Qhh, Gll^Qhh, Gs^Qhh
Ss, Sm, Gs^Fts, Dd, Ss, Wwf, Wwf^Bw|r, Ww, Ww, Wo, Ww^Ewf, Dd, Wwf, Wwf, Ss^Em, Ss, Gll^Ft, Ds, Gg^Es, Gg, Gg^Efm, Gg, Hh^Fp, Gs^Fms, Hhd, Wwf, Sm, Wwf^Ewl, Gg, Re^Eff, Gs^Fds, Hh^Efm, Hh^Fp, Co, Ce, Co, Gs^Qhh, Gll^Fms, Gs^Es, Gs
Ss, Gs^Ft, Ds^Es, Ds^Es, Sm^Em, Ww^Ewf, Ss^Vhs, Chw, Chw^Dr, Wo, Wo^Wkf, Ds^Es, Wwf, Ss^Em, Gs^Ft, Gg, Gg, Gs^Fts, Gg^Efm, Gs^Fms, Gg, Gg, Re^Vht, Re, Gs^Fp, Ww^Ewf, Gs^Fp, Wwf, Gs, Gll^Fms, Hh, Hh, Gs^Fms, Hh, Rr, Hh, Hh, Gg^Qhh, Hh^Efm, Hh
Ds, Dd, Ds, Ss^Em, Ww^Ewf, Ss^Em, Chw^Ewl, 2 Khw, Rb^Qhu, Ww^Wkf, Ww^Wkf, Wwrt, Ww, Ss, Gs^Ft, Gs^Fts, Gg^Em, Gg, Gg^Qhu, Gg^Qhuf, Hh^Fp, Gll^Fp, Gs^Fms, Gs^Fms, Gll^Fp, Ss, Hh^Fms, Ww^Es, Wwf^Es, Gs^Fms, Hh^Fp, Gs^Fms, Gs^Fms, Gg^Fet, Re, Hh, Hh^Fp, Hh^Fp, Gg^Qhh, Gs^Fp
Gs^Ft, Gs^Fts, Dd, Ss, Ss^Efm, Sm, Sm, Chw^Ewl, Ss^Em, Ds^Ewsh, Dd, Wo, Ww^Ewl, Gs^Ft, Gs^Ft, Gs^Ft, Gs^Fts, Gs^Fms, Gg^Qhuf, Gs^Qhu, Gll^Fp, Gs^Fms, Gs^Fms, Gll^Fp, Ss, Rb, Gs^Fp, Wwf^Em, Hh, Hh, Gs^Fms, Hh, Gs, Hh^Fp, Hh^Fp, Rr, Gs^Fp, Gs^Fms, Gs^Qhh, Gs^Qhh
Ds, Gs^Ft, Gs^Ft, Ds, Ds, Ww^Ewf, Ww^Ewf, Ss, Ss, Ww^Ewl, Ss, Wo, Ww, Ww, Ss, Ss, Gs^Ft, Gs^Ft, Gd^Qhu, Gd^Qhu, Gs^Fp, Gs^Fp, Ss, Ss, Ss, Ss, Gg, Gs, Hh, Gs^Fp, Gs^Fp, Gs^Fp, Hh^Fp, Hh^Fp, Gs, Re, Gs^Fp, Gs^Fms, Gs^Fp, Gs^Fp
