Gs, Gs, Gs^Fms, Gs, Gs^Fms, Gs^Fms, Re, Gs^Fms, Re^Fms, Re^Fms, Gs^Fms, Gg, Gll^Fms, Gg, Re, Gll, Gll^Efm, Gg, Rp, Ds, Wwt^Ewf, Wot, Wot, Wot, Ds, Gg, Gg, Gg, Gg, Gg, Gs^Fds, Gg, Gg^Qhhf, Gg^Qhhf, Gg^Qhhf, Gg, Gg, Gs^Fms, Gs^Fms, Gg, Gs^Fms, Gg, Gs^Fms, Gs^Fms, Gs^Fms, Gg, Gs^Fds, Gs^Fms, Gg^Qhhf, Gg
Re, Gs^Efm, Gs, Re^Fms, Re, Re^Fms, Re, Re^Fms, Re^Fp, Gd^Fetd, Gs^Fms, Gll^Efm, Re^Fms, Gs^Fms, Gll, Re, Gll, Rb^Ve, Rp, Ds, Wwt, Wot^Wkf, Wot^Wkf, Wot^Ewl, Dd, Ds, Gg^Es, Gg^Efm, Gg^Qhh, Gg, Gg^Qhhf, Gs^Fms, Gs^Fds, Gs^Fms, Gs^Fms, Gg^Qhhf, Gg, Gs^Fds, Gs^Fds, Gs^Fms, Gs^Fms, Gs^Fms, Gs^Fms, Gd^Fetd, Gs^Fms, Gs^Fms, Gs^Fds, Gg^Qhhf, Gg^Qhhf, Gg^Qhhf
Re, Re^Fms, Gs, Re^Edpp, Gll^Fms, Re, Re^Fp, Gll^Fp, Gll^Fp, Gs^Fms, Re^Fms, Re^Fms, Re, Gll^Edpp, Gll^Edpp, Gll^Fms, Rb, Re, Re, Rr, Wwt, Wot, Ds^Ewsh, Wwt, Ds, Gg^Edpp, Gg, Gg, Gg, Gg, Rb^Gvs, Gs^Fds, Gg, Gs^Fds, Gs^Fms, Gg, Gg^Efm, Gg^Qhhf, Gg, Gg, Gg^Efm, Gg, Gg, Gs^Fms, Gg, Gs^Fms, Gg^Qhhf, Gs^Fds, Gs^Fms, Gg
Rb, Gs, Re^Efm, Rb^Vh, Rp, Re, Hh^Fp, Gg^Ve, Gll, Gs^Fp, Gll^Fms, Re^Fms, Gll, Gll^Fms, Rp, Rb, Ds, Rr, Rrc, Rrc, Ww^Bw\, Wwt, Ds, Dd, Gg, Gs, Gg, Rb^Gvs, Rb^Gvs, Gg, Gg, Rb^Gvs, Gs^Fms, Gg, Gg, Gs^Fds, Gg, Gs^Fms, Gs^Fds, Gs^Fms, Gg, Gs^Fms, Gg^Es, Gg, Hh^Fp, Gg^Efm, Gg, Gs^Fds, Gs^Fms, Gg
Gll, Gll^Edpp, Re, Gll, Re, Chr, Chr, Rp, Gg^Efm, Gg, Re^Fms, Re^Fp, Gll^Es, Rb, Gs^Fms, Dd, Wwt^Ewl, Wwt^Wkf, Wwt, Ww^Bw\, Rrc, Rrc, Gg, Gg^Efm, Gg, Gg, Gs, Hh, Gg, Re^Vo, Re, Gg^Qhh, Gs, Gg^Edpp, Rb^Gvs, Gs^Fds, Gg^Efm, Gg, Gg^Qhh, Gg, Hh^Fms, Gg, Gs^Fds, Gg^Qhhf, Hh, Gs^Fms, Gg^Es, Gs^Fms, Gg^Qhhf, Gg
Gg, Gll, Gg, Hh^Fp, Hh^Fms, Chr, 1 Khr, Chr, Rp, Rp, Rb, Re, Rb, Rp, Rb^Ve, Wwt^Es, Wwt, Wot, Wot, Wwt, Dd, Re, Rr, Gg, Gs, Gs, Re, Re, Re, Re, Gg^Efm, Re, Gs^Fms, Gg, Re^Vo, Gg, Gg^Qhhf, Gg, Gg, Hh, Gg^Fms, Gg^Es, Gg, Gg^Qhh, Hh, Hh^Fp, Gg^Qhh, Gg^Es, Gs^Fms, Gg
Gg, Gg^Efm, Gll, Gg, Rp^Fp, Chr, Hh^Efs, Chr, Hh^Fp, Rb, Gg, Rp, Gll, Hh^Fms, Hh, Gll, Wwt^Wkf, Wot, Wwt, Wwt^Wkf, Ds, Rr, Re, Gg, Re, Re, Hh, Gs, Gg, Gs, Gg^Edpp, Re, Rr, Re, Hh, Rr, Gg^Qhh, Gg^Qhhf, Co, Gg, Gg^Qhhf, Gg, Gg^Efm, Hh, Gs^Fms, Hh, Hh, Hh^Fp, Gg^Qhhf, Gg
Ds, Ds, Dd, Gg, Rp, Hh^Fms, Hh^Fms, Hh^Fms, Hh^Fp, Gs^Fms, Gll, Hh^Fms, Hh, Hh, Wwt, Gg, Wwt^Bw\, Wwt^Ewf, Ds, Gg^Efm, Gg, Gg, Re, Rr, Gg, Gg, Rb^Gvs, Gg, Hh, Gg, Gg^Es, Gg, Gg, Gg^Qhh, Gg, Re, Rrc, Hh, 2 Ko, Co, Chr, Mm, Gg, Gg^Efm, Hh, Gg^Qhh, Hh, Gs^Fms, Gg^Qhhf, Gg^Qhhf
Wwt, Wwt, Wwt^Wkf, Ds, Gll, Rp, Hh, Hh, Hh, Gg^Efm, Hh^Fms, Hh^Fms, Wwt, Gg^Efm, Wwrt, Wwt, Wwt, Ds, Gg, Gs, Dd, Gs, Gg, Re, Rb^Ve, Rb^Gvs, Hh, Gg, Hh, Gs, Gg^Efm, Hh, Gs^Es, Gg^Es, Hh, Gg, Hh, Rrc, Co^Efs, Chr, Chr, Hh, Gg, Gg^Fms, Gg^Qhhf, Gg^Es, Gg, Hh, Hh^Fms, Gg^Qhhf
Wwt^Wkf, Wwt^Es, Wwt^Ewl, Wwt, Wwt, Rrc, Wwt, Wwt^Wkf, Hh, Hh, Ds, Wwt^Ewf, Wot^Wkf, Wwt, Wwrt, Wwrt, Wwrt, Gs, Ds^Ewsh, Ds, Gg, Ds, Re, Re, Rp, Hh, Hh, Gg, Gg, Gg, Gg, Gg, Hh, Gg, Re, Gs, Re, Gg^Qhhf, Rr, Rrc, Mm, Gg, Gg^Qhh, Gg^Es, Gg, Gg, Gg^Es, Gg^Qhhf, Gg^Qhhf, Hh
Ds, Dd, Ds, Wot, Wwt, Wwt^Bw|, Wwt^Es, Wwt, Rr^Ve, Gg, Wwt^Wkf, Wwt, Ds, Wwt, Ds, Wwt, Wwt, Wwt, Wwt^Ewl, Dd, Gg, Hh, Gg, Gs, Re, Re, Re, Gg, Re, Co, Rr, Re, Re, Rr, Gs, Rr, Gg, Rr, Hh, Gg^Qhh, Hh, Gg^Es, Gg, Gg^Fms, Gs^Fp, Gs^Fds, Gs^Fp, Gs^Fms, Gs^Qhhf, Gs^Qhhf
Gg, Ds^Ewsh, Dd, Ds, Ds, Rr, Ds, Wot, Wwt^Bw|, Wwt, Ds, Gs, Re, Gg, Ds^Vh, Dd, Ds, Wwt^Wkf, Wwrt, Hh, Hh, Hh, Mm, Hh, Gg, Gs, Gg, Re, Gg^Qhh, Re, Gg, Gg, Rb^Eff, Rb^Eff, Rb^Eff, Gg, Hh, Gg, Hh, Hh, Hh, Gg^Fms, Hh^Fp, Gg, Gg^Efm, Gg, Hh, Gg^Qhhf, Hh^Fms, Gg^Qhhf
Rb, Re, Re, Re, Re, Re, Re, Ds, Rr, Ds, Gs, Re, Ds, Re, Gg, Rb^Gvs, Gg, Gg, Wot, Wot, Mm, Hh, Hh, Hh, Gg^Es, Hh, Hh, Re, Gg^Qhh, Gg^Qhh, Rb^Eff, Rb^Eff, Sm^Emf, Sm^Gvs, Sm^Gvs, Rb^Eff, Rb^Eff, Gg, Hh, Gg^Efm, Gg, Hh^Fp, Gg^Qhh, Gg^Qhhf, Gg, Gg, Gg^Qhh, Hh, Gg^Qhhf, Gg^Qhhf
Gg^Wkf, Gg^Eff, Gg^Eff, Gs, Rb^Eff, Rb^Eff, Rb^Eff, Rb^Vh, Re, Gg^Efm, Ds, Re, Dd, Gg, Gg^Fms, Gg, Gs, Ds, Hh, Wwt, Hh, Gg^Qhh, Gg^Qhhf, Gg, Gs^Fms, Gs^Fms, Gg, Re, Re, Rb, Rb^Vh, Sm^Gvs, Sm^Gvs, Sm^Emf, Rb^Eff, Rb^Eff, Rb^Eff, Gg, Gg, Gg^Qhh, Gg^Efm, Gg^Fms, Gg, Gg^Fms, Hh, Gg^Qhhf, Gg^Qhh, Gg^Qhhf, Hh, Gg^Qhhf
Gg, Gg^Eff, Gs^Fms, Rb, Rb^Eff, Sm^Emf, Rb^Eff, Rb^Eff, Gs^Fms, Re, Re, Re, Gg^Efm, Gg, Gg, Gg, Gg^Efm, Gg, Dd, Wot, Wwrt, Gs^Fp, Hh^Fp, Gs^Fp, Hh^Fp, Gs^Fp, Hh, Hh, Hh, Hh, Gg, Rb^Eff, Rb^Eff, Rb^Eff, Rb^Eff, Rb^Vo, Rb^Eff, Rb^Eff, Gg, Gg, Hh^Fms, Gg^Qhhf, Gg, Gg^Efm, Gg, Gg^Qhhf, Hh, Gg^Qhhf, Gg^Qhhf, Hh
Gg, Gg^Efm, Gg, Gg, Gs, Rb^Eff, Gg^Fms, Gg, Re, Re, Gs^Fms, Gg, Gg^Fms, Gs, Gg, Gg^Fms, Gg, Gs, Gs^Fms, Gs^Fp, Wwrt, Gs^Fp, Hh, Gs^Fp, Hh, Gg^Qhhf, Gg^Qhh, Mm, Hh, Hh^Fms, Gg, Gs, Rb^Eff, Rb^Wm, Rb^Eff, Rb, Gs, Gs, Gg^Efm, Hh, Gg^Efm, Gg^Fms, Hh, Gg^Qhh, Gg^Qhh, Gg, Gg^Qhh, Gg^Qhh, Gd^Fetd, Gg^Qhhf
Gg, Gs^Edpp, Hh, Gg^Efm, Gg^Fms, Gg, Gs^Fms, Gg, Rp, Gs^Fms, Gg^Efm, Gg, Gg^Fms, Gg, Gg^Efm, Gs^Fms, Gg^Fms, Gg, Gs^Fms, Hh^Fp, Hh, Wwrt, Gs^Fp, Gg^Qhhf, Rb^Gvs, Hh, Gg, Hh, Gg, Re, Rp, Rb^Eff, Rb^Eff, Sm^Ewl, Sm^Ewl, Rb^Eff, Rb^Eff, Gs, Gg, Co, Gg, Gg, Gg, Gg^Qhhf, Hh, Gg^Qhhf, Gs, Hh, Gg^Qhhf, Gg^Qhhf
Gg, Gs^Fms, Rb^Gvs, Gg, Re, Gg^Fms, Re, Re, Re, Hh, Gg, Gs, Gs^Fms, Gg, Gs, Gg, Gg, Gg, Gg, Gs^Fp, Gs^Fp, Wwrt, Gs^Fp, Gs^Fp, Dd, Hh, Dd, Gg^Qhh, Rb^Gvs, Re, Gg, Re, Re, Rb^Eff, Rb^Eff, Rb^Eff, Re^Vo, Gg, Hh, Gg^Edpp, Gg^Es, Gg^Fms, Gg^Efm, Gg, Gg, Gs, Gg^Es, Hh, Gg^Qhh, Hh
Gs^Fms, Hh, Hh^Fms, Rb^Ve, Gg^Qhh, Re, Gs^Fms, Hh, Hh^Fms, Gs, Gg, Gg^Fms, Gg, Gg, Gg, Hh^Fms, Gg, Hh, Gg, Gg, Wwt, Wwr, Gg, Ds, Wwt^Wkf, Wwt, Wwt^Es, Ds, Hh, Gg, Hh, Gg^Es, Rp, Gg^Efm, Gs, Gs, Rp, Gg, Gg, Gg, Gg, Gg^Efm, Gg, Gg^Qhh, Gg, Gs^Qhh, Hh, Gg^Qhh, Hh, Hh
Gg^Fms, Gg^Fms, Mm, Gg^Fms, Hh, Hh, Gg^Fp, Gg^Fp, Gg^Qhh, Re, Re, Gg^Edpp, Rb^Gvs, Hh^Fms, Gg, Gg^Fp, Gs^Fms, Hh^Fp, Gg, Gg^Es, Ds, Wwt^Ewl, Wwt, Wwt, Wot, Wot, Wwt^Wkf, Ds, Gg^Es, Gg, Gs^Efm, Gg, Re, Gg, Rb^Eff, Gg, Hhd, Rp, Rrc, Co, Hh, Gs^Edpp, Hh, Gg^Es, Gs, Gs^Qhhf, Gg^Qhh, Gg, Hh, Gg^Qhhf
Mm, Hh^Fp, Mm, Mm, Hh^Fp, Mm, Hh, Gg^Fp, Mm, Mm, Gg, Hh^Vhh, Hh^Gvs, Re, Hh^Vhh, Rb^Gvs, Gg^Fp, Hh, Gg^Fp, Hh, Gg, Wwt^Wkf, Wwt, Wot^Wkf, Wot, Wwt, Dd, Gg, Gg, Gs, Rp, Re, Rb^Eff, Rb^Eff, Sm^Gvs, Rb^Eff, Rb^Eff, Re, Chr, Chr, Co, Gg, Gs, Gg^Efm, Gg^Qhh, Gs, Gs^Qhh, Gg^Qhhf, Hh^Fms, Gg
Wwt, Gg^Qhh, Mm, Hh, Mm, Mm, Mm, Hh^Fp, Hh, Gg^Qhh, Hh, Re, Hh^Gvs, Mm, Hh^Fp, Mm, Hh^Fp, Gg^Qhhf, Gg^Fp, Gg^Fp, Hh, Wwt, Wwt^Ewf, Wot, Wwt, Wwt, Wwt^Ewl, Ds, Gg, Gd, Rp, Re^Vo, Rb^Eff, Sm^Gvs, Sm^Emf, Sm^Emf, Rb^Eff, Re^Eff, Co, 3 Ko, Rrc, Hh, Gg, Gg, Gg, Gs, Gg, Gg, Gg^Qhh, Gg
Wot, Wot^Ewf, Rrd, Mm, Mm, Mm, Hh^Fp, Hh, Mm, Hh^Fp, Gg, Re, Rp, Hh^Fp, Hh^Fp, Hh^Gvs, Hh^Gvs, Hh^Fp, Gg^Qhhf, Gg^Fp, Gg, Gg, Ds, Wwt, Wot, Wwt^Wkf, Wwt, Gg, Re, Re, Gg, Gg^Efm, Gg, Rb^Eff, Rb^Eff, Rb^Eff, Gg, Rr, Hh^Ebn, Co^Efs, Mm, Rr, Re, Gg^Fms, Gg, Hh, Gg^Efm, Gg^Fms, Hh, Gg
Ds, Wot, Dd, Hh^Fp, Gg^Fp, Hh, Gg^Qhhf, Hh, Mm, Mm, Hh, Mm, Hh^Vhh, Re, Hh^Fp, Hh^Vhh, Gg^Qhhf, Mm, Hh^Fp, Hh, Hh, Mm, Hh, Dd, Ds, Wwt, Wot^Bw/, Rr^Efs, Dd^Efs, Re, Re, Gs, Gg, Gd^Efm, Gd, Hhd, Gg, Gd, Hh, Rr, Hh, Hh, Rp, Gg^Efm, Gg^Fms, Gs, Gs^Edpp, Hh, Hh^Fms, Hh
Wot, Wot^Bw\, Ds^Vh, Rp, Re, Gg^Qhhf, Gg^Fp, Mm, Gg^Fp, Rp, Hh^Fp, Mm, Mm, Mm, Hh, Hh^Es, Hh, Hh^Fp, Mm, Hh, Mm, Mm, Gg, Gg^Efm, Re^Efs, Rr, Wot, Wwt, Ds^Ewsh, Gg, Gd, Re, Gd, Hhd, Gs, Hh, Gg, Gg, Rp, Re, Gd, Gs, Gs, Re, Re, Re, Re, Rrd, Wwt, Wwt
Wwt, Wot, Wwt, Wwt, Re, Gg^Efm, Gg^Fp, Mm, Re, Hh, Hh, Hh, Hh^Fp, Gg^Qhhf, Hh^Fp, Gg, Gg^Fp, Mm, Gg^Fp, Gg^Fp, Gg, Hh, Gg, Gg^Es, Re, Gg^Efs, Wot^Wkf, Wwt, Wwt, Gg^Efm, Gd, Re, Gs, Gg^Efm, Rp, Gg, Gd, Re, Gg, Gs^Efm, Dd, Hhd, Gd, Gg^Edpp, Hh, Gs^Fp, Re, Wwt^Wkf, Hh, Hh
Hh, Wwt^Ewl, Mm, Ds, Gg^Efm, Re, Re, Re, Hh, Hh^Vhh, Mm, Hh^Fp, Gg^Fetd, Gg^Qhh, Gg^Edpp, Gg^Fms, Gg, Gg^Qhhf, Gg^Fp, Gg, Gg, Gg^Fms, Rb^Eff, Rb^Eff, Rb^Eff, Re^Vc, Wwt, Wwt, Wot^Wkf, Dd, Rr, Re, Re, Re, Rb^Gvs, Re, Re, Re^Vh, Rb^Gvs, Ds, Ds, Gs^Efm, Gd, Gs^Fms, Wwt, Wwt^Ewl, Wwt, Wwt^Bw\, Re, Gg^Efm
Hh^Fp, Hh, Hh, Hh^Fp, Hh, Hh^Fp, Re, Hh^Fp, Mm, Mm, Mm, Gg^Fp, Mm, Gg, Gg^Fms, Gg, Gg^Efm, Gg, Gg, Gg^Efm, Hh, Gg, Gg^Fms, Rb^Eff, Gs, Re, Gg^Gvs, Wwt^Es, Wwt, Wwt, Wwt^Bw|, Ds, Ds, Gd^Vo, Ds, Gd, Ds, Dd, Gd, Gg, Gg, Gd, Dd, Gs^Fp, Wwt, Hh^Fp, Hh, Gs^Fp, Gs^Fp, Re
Hh, Gg^Ve, Mm, Mm, Re, Re, Mm, Mm, Mm, Mm, Gg^Fp, Mm, Mm, Gg^Efm, Hh^Fp, Mm, Mm, Gg, Gs^Fp, Mm, Hh, Gg^Fms, Gg, Gg, Re, Re, Gg, Ds, Dd, Wwt^Wkf, Rrc, Wwt, Wwt^Wkf, Wwt, Wwt, Dd, Wwt, Dd, Ds, Ds, Gd, Ds, Wwt, Wwt^Wkf, Hh^Fp, Hh^Fp, Gs^Fp, Gg, Gs^Fms, Gg
Gg^Fp, Hh^Fp, Hh, Re, Hh, Hh^Fp, Gg^Fp, Mm, Gg^Fp, Gg^Fp, Gg^Qhhf, Mm, Gg^Fp, Gg, Gg^Fms, Gs^Fp, Gg^Qhhf, Hh, Gs^Fp, Hh, Mm, Gg, Gs^Fp, Gg, Re, Gs, Gs^Efm, Gg^Efm, Gg, Rr, Gs, Wwt, Wwt^Ewf, Wot, Wot, Wwt^Ewl, Wot, Wwt^Wkf, Ds, Gd^Edpp, Ds, Dd, Wwt, Gs^Fp, Hh^Fp, Hh, Gs, Gd^Efm, Gd, Hh^Fp
Hh, Gg^Fp, Gg^Es, Re, Rp, Gg^Fp, Gg^Eff, Gg^Qhhf, Re, Rb^Gvs, Gg^Fp, Gg, Gs, Gs, Gg^Fms, Hh, Hh, Gs^Fp, Hh, Gs, Hh, Re^Ve, Re, Re, Gs^Efm, Gg, Rb^Eff, Gg, Gs, Rr, Gg, Ds, Wot^Wkf, Wot, Wot, Wot^Wkf, Wot, Wwt, Wwrt, Gd, Ds, Wwt^Wkf, Wot, Gd^Fms, Gd, Hh, Gs, Gd^Fms, Gd^Fetd, Gg
Hh, Gg^Fp, Gg^Fp, Hh, Gg, Re, Re, Re^Vo, Gg, Rr, Rrc, Gg, Hh, Gs, Gg, Gg, Hh, Mm, Hh, Gg, Gg^Fms, Gg, Re, Gg, Rb^Eff, Rb^Eff, Sm^Gvs, Rb^Eff, Rb, Re, Rp, Ds, Wwt, Wot, Wot^Wkf, Wot, Wot, Wot, Ds, Wwt, Wwt, Wwt, Wot, Wwt^Wkf, Ds, Rrd, Ds, Gd, Gd, Gg^Efm
Hh^Fp, Gg^Fp, Hh^Fp, Gs^Edpp, Gg, Gg^Fp, Rp, Rb^Gvs, Hh, Hh^Eb, Md, Co, Co, Hh, Rrc, Gs, Gg^Fms, Gg, Rr, Gg^Fms, Rr, Gg, Rr, Rb^Eff, Rb^Eff, Sm^Gvs, Rb^Eff, Rb^Eff, Ds, Gg, Rp, Ds, Dd, Wwt^Wkf, Wwt, Wwt, Wot, Dd, Dd, Wot, Wwt^Wkf, Wwt, Wot, Wwt, Wwt^Wkf, Dd, Ds, Gd, Ds^Es, Gd
Gg, Gg^Fp, Hh^Fp, Gs^Fp, Gs^Fp, Gs, Re, Hh, Hh, Md, Mm, 4 Ko, Chr, Chr, Gg^Eff, Rr, Rrc, Rr, Gg, Re, Gg, Re, Dd, Gg, Gs, Rb, Ds, Dd, Gs, Gd, Gd, Re, Re, Ds^Edpp, Wwt, Wwt^Wkf, Wwrt, Dd, Wot, Wot^Ewf, Wot, Wot, Wot, Wot, Wwt^Ewl, Wwt, Dd^Edpp, Ds, Ds, Gd
Hh^Fp, Hh^Fp, Hh^Fp, Hh, Gg, Hh, Re, Co, Rr, Hh^Es, Rrc, Co^Efs, Hh^Eff, Gs^Fdf, Gg^Eff, Hh^Eff, Gs, Gg^Fms, Gg, Gs^Efm, Gg, Ds, Gs, Gg, Ds, Gs^Efm, Gg, Gs, Ds, Hh, Rrd, Dd, Re, Ds^Ewsh, Dd, Ds, Wwt, Wot, Wot, Wwt, Wwt^Wkf, Wot, Wwt, Wot, Wot, Ds, Gd, Ds, Gd, Ds
Hh, Hh, Hh, Gs^Fp, Gs, Gg^Fp, Rr, Rr, Gg, Rrc, Gs, Hh, Hh, Gs^Eff, Gg, Gs, Gg, Gg, Gs^Efm, Gg, Gd, Gg^Es, Gs, Gd, Dd, Gs, Dd, Gs, Rrd, Dd, Gd, Dd, Re, Gd, Gd^Fms, Ds, Wwt, Wwt, Wwt, Wot, Wwt^Wkf, Wwt, Wwt, Wwt, Wwt^Es, Ds, Gd^Edpp, Ds^Es, Ds, Ds
Hh, Md, Hh, Hh, Gs, Hh, Rr, Re^Vo, Rb^Gvs, Hh, Gs, Gg, Gs, Gs, Gs, Hh, Gd, Gg, Gg, Gs, Ds^Edpp, Ds, Ds, Gg, Ds, Ds^Edpp, Gg, Ds, Gd, Hhd, Re, Rp, Dd, Ds, Ds^Edpp, Gd, Wwt, Wot^Ewl, Rrd, Rrd, Ds^Edpp, Ds, Ds, Wwt^Wkf, Ds^Es, Ds, Ds, Ds^Edpp, Ds, Ds
Hh, Hh, Gg, Gs^Es, Gg, Rr, Gs, Gg^Eff, Gs^Eff, Gs^Eff, Ds, Gs, Gs, Gs^Efm, Ds, Gg, Gg, Gg, Gd, Dd, Dd, Dd, Ds, Gg, Hhd, Gg^Edpp, Ds, Gd, Gg, Gs^Fms, Re, Gs^Fp, Mm, Gs^Fp, Gs^Fp, Dd, Wot, Wwt^Wkf, Hh, Hh, Gg, Gd, Ds^Edpp, Ds^Edpp, Ds, Dd, Gd, Dd, Ds, Gd
Gg, Gd, Rrc, Rr, Rr, Rr, Gg, Gg, Gd, Gd, Gg, Gd, Gd, Gd, Gs, Gd, Gd, Ds, Gd, Gd^Edpp, Ds, Dd, Rrd, Dd, Hhd, Rrd, Gs, Gs^Fms, Gd, Gs^Fms, Hh^Fms, Re, Hh, Gs^Fp, Gd, Wwt, Wwt, Gs^Fp, Mm, Gs^Fp, Gd^Fp, Ds, Dd, Gs, Ds, Ds, Ds^Edpp, Ds, Dd, Ds
Gg, Rr, Ds, Gd, Gg, Gd, Gd, Gg, Gd, Gg^Es, Gg, Ds, Ds^Edpp, Gd^Edpp, Gd, Ds, Dd, Gd, Ds, Dd^Edpp, Ds, Gd, Dd, Hhd, Rrd, Gd, Gs^Edpp, Ds, Hhd, Gs^Fms, Hh, Re, Rp, Ds, Gs, Hh, Dd, Wot, Wwt, Gg^Edpp, Gd, Gd, Ds, Ds, Ds, Gd, Dd, Dd, Dd, Dd
Re, Re, Gd^Fetd, Gg, Ds, Gg^Edpp, Dd, Gg, Dd, Ds, Gd, Ds, Gs^Efm, Gd, Gd^Edpp, Ds, Gg, Gd, Gd, Ds, Hh, Gd, Hh, Hh, Hh, Gs, Gd, Ds, Hh^Fms, Gs^Fms, Gd, Hh, Re, Hh, Gd, Gd, Wwt, Wot, Wwt^Wkf, Gs, Ds, Dd, Ds, Gd, Ds^Edpp, Ds, Dd, Ds^Es, Dd, Dd
Gg, Ds, Gd, Ds, Gd, Dd, Gd, Ds^Edpp, Ds, Gg, Ds, Gg, Gg, Ds, Gd, Gd, Ds, Ds, Gd, Gs, Gd^Fetd, Gs, Hhd, Hh, Ds^Edpp, Ds, Hh, Gs, Gd^Edpp, Ds, Hh, Ds^Edpp, Re, Hh, Gs, Ds, Wot^Ewl, Wwt, Gd, Gg, Rrd, Dd, Gd, Ds, Dd^Edpp, Ds, Dd, Dd^Edp, Dd, Dd
Ds, Ds, Ds, Gg^Edpp, Gg, Ds, Gg, Gd^Edpp, Gg, Gd, Gg, Ds, Gg, Gg, Gg, Ds, Gg, Ds, Gg, Ds, Gd, Ds, Hhd, Ds, Gg, Gg, Hh, Hh, Hh, Gs, Gg, Re, Gg, Hh, Hh, Gs, Ww, Wwt, Gg, Hh, Gg, Ds, Gg, Ds, Ds, Ds^Edpp, Ds, Dd, Dd, Dd
