Ww, Ds, Ss, Gd, Gs, Hh, Ds, Ww, Ww^Ewf, Ww^Ewf, Wwr, Gg, Mm, Mm, Mm, Mm, Mm, Mm, Ha^Fpa, Ha, Ms, Ms, Ms, Mm, Mm, Gg, Mm, Ms, Ms, Ms, Mm, Hh, Mm, Mm, Mm, Ha, Ha, Ms, Mm, Mm, Mm, Mm
Ww^Wkf, Ds, Ww, Ds, Ds, Hh^Fms, Hh, Wwr, Ww, Wo, Ds, Gs, Ha, Mm, Ha^Fpa, Mm, Hh^Es, Mm, Ww^Wkf, Hh, Mm, Ms, Mm, Ha, Mm^Fpa, Mm, Hh, Ms, Mm^Fpa, Mm, Ha, Ha, Ms, Mm, Mm, Mm, Ha^Fpa, Ha^Fpa, Hh^Fms, Hh^Es, Rp, Rp
Hh, Wo, Ww^Ewf, Ww^Wkf, Ww, Wwr, Gg, Rb^Gvs, Gd, Ww^Wkf, Hh^Fms, Gd, Hh, Ms, Ms, Ha^Fpa, Mm, Wwr, Hh, Wwr, Wo, Hh, Hh, Hh^Fpa, Hh, Hh^Fms, Mm, Mm, Mm, Mm, Ha, Ms, Mm, Mm, Mm, Mm, Hh^Fpa, Mm, Mm, Rb, Ms, Ms
Hh, Hh, Mm, Hh, Hh, Wo, Ww^Wkf, Ds, Ds, Gg^Efm, Hh, Hh^Fms, Hh^Fpa, Hh^Fms, Mm, Mm, Mm, Mm, Hh^Fp, Hh^Fpa, Ww^Wkf, Ww^Ewf, Hh^Fetd, Mm, Mm, Hh, Hh^Fms, Mm, Mm, Hh, Mm, Ha^Fpa, Mm, Mm, Mm, Mm, Mm, Hh^Es, Ms, Ms, Ms, Ms
Mm, Hh^Fms, Hh^Fms, Ha, Mm^Fpa, Wo, Hh^Fpa, Ww^Ewf, Ds, Hh, Gs, Gs^Efm, Hh^Fms, Hh, Mm, Mm, Hh^Es, Hh^Fp, Hh^Fms, Hh, Hh^Fms, Wwr, Hh^Fms, Mm^Fpa, Mm, Mm, Mm, Hh^Es, Mm, Hh, Hh^Fms, Hh^Fpa, Ms, Ms, Hh^Fpa, Mm, Hh^Es, Hh^Fetd, Mm, Ms, Ms, Ms
Ms, Mm, Mm, Mm, Hh^Fp, Mm, Hh, Hh^Fp, Hh^Fms, Rb, Gd^Efm, Rb, Hh, Hh, Gg^Fms, Hh, Hh, Hh^Fms, Hh, Hh, Ss, Ww^Wkf, Wo, Hh, Hh^Fms, Hh, Mm, Hh, Hh, Hh^Es, Mm, Mm, Mm, Mm, Mm, Hh^Vhh, Hh^Es, Mm^Fpa, Mm, Mm, Mm, Ms
Mm, Mm^Fpa, Mm^Fpa, Mm, Hh, Hh, Hh^Fp, Gg^Fetd, Hh, Gg, Hh^Fms, Hh, Gg^Fms, Gg^Fet, Gg^Fms, Gg^Fms, Hh^Es, Gg, Rb, Hh^Fds, Gg, Ww^Ewl, Ww^Wkf, Gg, Ww^Wkf, Wo, Ww, Ww^Wkf, Ds, Hh^Fpa, Mm, Mm, Mm, Mm, Rb, Hh, Mm, Mm, Mm, Mm, Mm, Ms
Hh, Mm, Hh^Fp, Hh, Gg, Gg^Fms, Rp, Gg^Es, Chr, Gg, Hh, Gg, Gs, Rb^Gvs, Rb^Gvs, Rp, Rp, Hh^Fds, Rp, Gg, Hh, Ds, Gg, Wwr, Ds, Ww, Ds, Wo, Wwr, Wo, Ds, Mm, Mm, Hh, Mm, Rb, Rb, Mm, Mm, Mm, Mm, Mm
Hh^Fms, Hh, Hh^Fp, Hh^Fms, Hh^Fms, Gg^Edpp, Chr, 1 Khr, Chr, Chr, Hh, Rb^Vh, Gg^Eff, Rb^Gvs, Gg^Eff, Gg^Eff, Hh^Fds, Rp, Hh^Es, Rb, Rp, Rb, Rp^Vh, Gg, Gg, Ss, Gg^Fms, Ss, Ds, Wo^Wkf, Ds, Hh^Es, Mm, Mm, Mm, Hh^Vhh, Mm, Rp, Hh^Fms, Mm, Mm, Mm
Gg, Hh^Fms, Gg, Hh^Vh, Gg^Efm, Chr, Gg^Fds, Chr, Gg, Hh^Fms, Gg, Gg^Fms, Gs^Fms, Gg^Eff, Gg^Fds, Gg^Efm, Hh, Gg^Es, Gg^Edpp, Gg, Gs^Fms, Gg, Rp, Gg, Gg^Fms, Gg, Gs, Gg, Wo^Wkf, Ww, Ds, Hh^Fms, Ds, Ds, Rb, Mm, Mm, Hh, Hh^Es, Hh^Fpa, Rp, Hh
Gg, Hh^Fms, Gg^Es, Gg, Gg^Fms, Gg, Rb^Vh, Rb, Gg^Fds, Gg, Gg^Es, Gs^Fms, Gg^Efm, Gg, Gs, Gg, Gg, Gg^Efm, Gg^Fms, Gs, Gg, Gg, Hh, Rb, Rb, Rb, Rp, Ds, Ds, Ww^Wkf, Ww, Wo^Wkf, Ww, Wo^Wkf, Ds, Rp, Rp, Rp, Mm, Mm, Rb, Hh
Gg^Fds, Gg^Efm, Gg, Gg^Fms, Rb^Gvs, Rb^Gvs, Gs, Rp, Rp, Gg, Rp, Gd, Gs, Gg^Es, Gg, Gs^Fds, Gg^Efm, Gg^Es, Gg, Gs, Hh^Fms, Gg^Fms, Gs^Es, Hh, Gg^Es, Rb, Rp^Vh, Gg^Fds, Gg^Eff, Wwr, Ww^Wkf, Ww^Ewf, Wo, Ww, Ww^Wkf, Rb, Hh^Es, Hh^Fms, Mm, Rb, Mm^Fpa, Mm
Gg, Gg, Gg^Fms, Gs, Gg^Fms, Gg, Rb, Rp, Hh, Rb, Hh^Es, Rb, Gs^Fds, Gs, Rb^Vh, Gg, Gg, Gg, Gg^Fds, Gs, Gd, Gg, Rb, Gg, Gs, Rb, Gg^Eff, Gg^Wm, Gg^Eff, Gg^Eff, Ds, Gg^Fds, Ds, Ww, Wwr, Ds, Rp, Rb, Rb, Rb, Mm^Fpa, Hh
Rb, Gg, Gg^Efm, Gs, Gg, Gg^Es, Rb, Gg, Hh^Efm, Gg, Gg^Efm, Rb, Rb, Gg, Rb, Rb, Rb, Hh, Hh, Gg, Rb, Rb, Gg^Es, Rb, Gg, Rb, Rb, Gd^Eff, Gs, Rb, Gg^Fds, Gg, Ds, Ww^Ewl, Wo, Ds, Rb, Hh, Mm, Mm, Mm, Hh
Gg, Rb, Hh, Gg^Fds, Gg, Hh, Rb, Gd, Gg, Hh^Fds, Gg^Fds, Gg, Hh, Rb, Hh, Hh^Fds, Rp, Gg, Hh, Gs, Rp, Hh^Fds, Gg^Es, Rb, Rb, Gg, Rb, Rb, Chr, Rb^Gvs, Gg, Gg^Fds, Wo, Ww^Wkf, Rp, Rp, Hh, Ds, Hh, Mm, Hh, Mm
Gs, Rb, Rb, Hh, Gs^Es, Rp, Rp^Vh, Gs^Fds, Gd^Efm, Gs, Gs, Gg, Gs^Es, Gs, Gg^Efm, Hh, Gg, Rb, Rb, Rb, Hh, Hh, Gg^Fds, Hh, Gg^Es, Rb, Chr, Chr, 2 Khr, Chr, Gg, Gg^Efm, Ww^Bsb/, Ww^Bsb/, Ds^Efs, Hh^Fms, Ds, Ds, Ww^Wkf, Ds, Ds, Mm
Gs, Gs^Fds, Rb, Gs^Efm, Rb, Rb, Hh, Gg, Gd^Es, Gs^Edpp, Gs, Gg^Es, Gs, Gg, Gs, Hh, Gs, Gs^Fds, Gs, Re, Gg^Efm, Gs, Gs, Hh^Es, Gs, Gs, Rb^Gvs, Chr, Gs, Chr, Rp, Rp^Efs, Ds^Efs, Wwr, Ww, Ds, Wo^Wkf, Ds, Ww, Ww^Ewl, Ww^Wkf, Hh
Gg, Gs, Rb^Efm, Rb, Gs^Edpp, Gs, Ds, Gs^Efm, Gd, Gs, Hhd^Fmw, Hh, Gs, Gd, Gs^Es, Gg^Efm, Gs, Gg, Re, Re, Gs, Gs, Gs^Efm, Gs, Gs, Rb^Gvs, Rb^Gvs, Rb^Gvs, Rb^Vh, Rb, Ds, Ds, Ww^Wkf, Wwr, Ww, Ww^Ewl, Wo, Ww^Wkf, Ww^Ewf, Wo, Ds, Hh
Gs, Rb^Es, Gs^Edpp, Gd, Hhd, Gg, Gd, Hhd, Gd, Gd^Fmw, Hhd, Hhd^Es, Ds, Gd^Fmw, Gs^Edpp, Gs, Gs, Rb^Vh, Re, Gs, Gs, Hh, Gd, Hh, Gs^Edp, Gs, Gs, Gg^Fms, Gg, Gg, Gg, Ds, Wo^Ewf, Wo, Wo^Wkf, Wo^Wkf, Wo, Wo, Ww, Ww^Ewl, Gg^Es, Gg
Hh, Re^Es, Gs^Fmw, Gs, Gs^Fmw, Hhd^Fmw, Ds^Fetd, Ds^Dr, Ds, Ds^Edpp, Hhd, Gd^Fetd, Dd, Gd, Gd, Gs, Ds, Rb, Rb, Gs^Efm, Gd^Fmw, Gd, Gs^Es, Gs, Gs, Gs, Gs^Efm, Gg, Hh, Gg^Fds, Gg, Wo^Ewf, Ww^Wkf, Wo, Wo, Wo, Wo, Ww^Wkf, Ww^Wkf, Ds, Gg^Fms, Ds
Hh, Re, Re, Hhd, Md, Md, Hhd^Fmw, Hhd, Dd, Gd, Ds^Dr, Ds, Ds, Ds, Hhd, Gd^Fmw, Ds, Gd^Edpp, Re, Gd, Gd, Gd, Gd^Efm, Hh, Gd^Efm, Gg, Gg, Hh^Fds, Gs^Fet, Ds, Ds, Ds, Ww^Ewl, Ww, Wo^Wkf, Ww, Ww, Ww^Wkf, Ds, Ds, Ds, Gg
Gd, Gd^Fmw, Gd^Fmw, Gd, Hhd, Md, Ds^Dr, Hhd, Ds^Edpp, Ds, Hhd, Hhd, Ds, Gd, Dd, Ds^Dr, Gd^Fetd, Re, Gd, Ds, Gd, Ds, Gd^Fmw, Gd, Gs, Gs, Hh, Gs, Gg^Fms, Gg^Fds, Gg^Fds, Ds, Ds, Ww^Wkf, Ds, Ww^Ewf, Ds, Wwr, Wo^Ewl, Ds, Ds, Gg
Gd, Gd, Dd, Gd, Ds^Edpp, Hhd, Gd^Fetd, Hhd, Ds, Gd^Fmw, Hhd, Ds, Hhd, Ds, Ds^Edpp, Ds^Edp, Ww, Re, Gd^Edpp, Gd, Ds^Edpp, Ds, Gd^Edpp, Gs, Gs, Rb, Gg, Gs^Efm, Hh, Hh, Gs^Fms, Ds, Gg^Fds, Ds, Gg, Ds, Ds, Ww, Ww, Ds, Ww^Wkf, Ds
Gd, Ds, Ds, Ds, Re^Efm, Re, Re, Re, Re, Ds^Edpp, Gd, Ds, Re, Ds, Ww, Dd^Dr, Wwr, Ds, Gd, Gd, Ds, Ds, Gd, Gs^Fmw, Gs^Fmw, Rb, Gd^Es, Gs, Hh^Ebn, Hh^Es, Gs, Hh, Gd, Ds, Gg^Fms, Gg^Fds, Ds, Wo^Wkf, Ww^Wkf, Wwr, Wwr, Ww
Gd, Gd^Fetd, Ds, Gd, Re, Ds, Ds^Dc, Dd, Ds^Edp, Re, Re^Efm, Re, Dd, Ww^Wkf, Wo, Ww^Wkf, Ww, Gd, Ds, Ds, Gd, Gd, Gd^Fmw, Gs, Rb, Rb, Gs, Gs, Gs^Edpp, Hh, Gg^Efm, Gg, Gg^Fds, Gs, Gs^Vh, Gg, Gg^Fds, Ds, Ds, Ds, Ds, Ww
Ds, Ds, Ds, Re, Ds, Ds, Ds, Ds^Edp, Dd, Ds, Ds, Dd, Dd, Ds, Dd, Re, Dd, Ds, Dd^Edp, Ds, Ds, Ds, Ds, Rb^Vdt, Ds, Gd^Edpp, Hh, Gs, Gg, Gg, Gg, Gs^Efm, Chr, Chr, Chr, Ds^Efs, Gg, Ds, Gs^Fds, Gg^Es, Ds, Wo
Ds, Gd, Ds, Re, Re, Gd, Ds^Qhh, Ds^Edp, Dd, Ds^Qhh, Uh^Dr, Ds^Edp, Ds^Edp, Ds, Dd, Re, Ww, Dd, Ds, Dd, Dd, Ds, Ww^Wkf, Rb, Ds, Gd, Hh, Gs, Gs^Vh, Gs^Efm, Gg, Gs, Chr, 3 Khr, Chr, Gs, Gg^Fds, Gg, Gs^Es, Ds, Ds, Ds
Ds, Ds^Edp, Dd, Ds, Re^Efm, Ds^Dr, Ds, Dd, Dd^Qhh, Uh^Dr, Hhd, Ds^Qhh, Uh^Dr, Dd, Dd, Dd, Ds^Dr, Ds, Ds, Wwr, Ww, Wo, Ww, Dd^Dr, Ds, Gd^Fetd, Gs^Fmw, Gs, Gs^Edpp, Gs, Gs^Edpp, Hh, Gs, Chr, Gs, Gg, Gg^Efm, Gs, Hh, Gg^Efm, Gg^Efm, Gg
Dd, Ds^Edp, Dd^Qhh, Ds, Dd^Edp, Ds, Dd^Qhh, Hhd, Mdd, Mdd, Dd^Edp, Mdd, Ds^Qhh, Dd, Mdd, Ds^Qhh, Ds^Qhh, Dd^Edpp, Ds^Edpp, Ds, Dd^Edp, Dd^Dr, Dd^Edp, Dd, Ds, Ds, Gd, Gd, Hh^Edpp, Hh, Gs, Gg^Es, Hh, Hh, Gg, Gg, Gs^Es, Gg, Gg, Gg^Fds, Hh, Gg^Es
Ds, Ds^Qhh, Ds^Qhh, Ds^Edpp, Ds^Dr, Hhd, Mdd, Ds^Qhh, Mdd, Mdd, Hhd, Hhd, Mdd, Mdd, Hhd, Hhd, Mdd, Ds^Dc, Hhd, Dd, Ds, Ds^Edp, Ds, Ds^Edpp, Ds, Ds^Edp, Gg, Gd, Gg, Gg, Gg, Hh, Gg, Hh, Gg, Hh, Gg, Gg^Es, Gg, Gg, Gg, Gg
