border_size=1
usage=map

_off^_usr   , _off^_usr   , _off^_usr   , _off^_usr   , _off^_usr   , _off^_usr   , _off^_usr   , _off^_usr   , _off^_usr   , _off^_usr   , _off^_usr   , _off^_usr   , _off^_usr   , _off^_usr   , _off^_usr   , _off^_usr   , _off^_usr   , _off^_usr   , _off^_usr   , _off^_usr   , _off^_usr   , _off^_usr   
_off^_usr   , Cud         , 2 Kud       , Xu          , Xu          , Xu          , Xu          , Xu          , Ww          , Xu          , Xu          , Ww          , Ww          , Xu          , Xu          , Xu          , Xu          , Xu          , Xu          , Xu          , Xu          , _off^_usr   
_off^_usr   , Cud         , Cud         , Cud         , Xu          , Xu          , Uu          , Xu          , Xu          , Ww^Bw\      , Uu          , Ww^Bw/      , Xu          , Xu          , Xu          , Xu          , 3 Kud       , Xu          , Xu          , Xu          , Xu          , _off^_usr   
_off^_usr   , Uu          , Xu          , Uu          , Xu          , Xu          , Uu          , Xu          , Xu          , Xu          , Uu          , Xu          , Xu          , Xu          , Xu          , Cud         , Cud         , Cud         , Uu          , Xu          , Xu          , _off^_usr   
_off^_usr   , Uu          , Xu          , Uu          , Uu          , Uu          , Uu          , Xu          , Xu          , Xu          , Uu          , Xu          , Xu          , Xu          , Xu          , Uu          , Uu          , Uu          , Uu          , Xu          , Xu          , _off^_usr   
_off^_usr   , Uu          , Xu          , Xu          , Xu          , Uu^Vu       , Uu          , Xu          , Uu          , Uu          , Uu          , Xu          , Xu          , Uu          , Uu          , Xu          , Xu          , Uu          , Uu          , Xu          , Xu          , _off^_usr   
_off^_usr   , Uu          , Uu          , Xu          , Xu          , Xu          , Uu          , Uu          , Xu          , Xu          , Uu          , Xu          , Xu          , Uu          , Uu          , Xu          , Xu          , Xu          , Xu          , Uu^Vu       , Xu          , _off^_usr   
_off^_usr   , Uu          , Uu          , Xu          , Uu          , Uu          , Uu          , Xu          , Xu          , Xu          , Uu          , Uu          , Uu          , Uu          , Uu          , Xu          , Xu          , Xu          , Uu          , Uu          , Xu          , _off^_usr   
_off^_usr   , Uu          , Xu          , Xu          , Uu          , Xu          , Uu          , Xu          , Xu          , Xu          , Xu          , Uu          , Xu          , Uu          , Xu          , Xu          , Xu          , Xu          , Uu          , Uu          , Uu          , _off^_usr   
_off^_usr   , Xu          , Xu          , Xu          , Uu          , Uu          , Xu          , Xu          , Xu          , Xu          , Xu          , Uu          , Xu          , Xu          , Uu          , Xu          , Xu          , Xu          , Xu          , Uu          , Uu          , _off^_usr   
_off^_usr   , Xu          , Xu          , Uu          , Uu          , Xu          , Xu          , Uu          , Uu          , Xu          , Uu          , Uu          , Xu          , Uu          , Uu          , Uu          , Xu          , Xu          , Xu          , Xu          , Uu          , _off^_usr   
_off^_usr   , Xu          , Xu          , Uu          , Uu          , Xu          , Uu          , Uu          , Uu          , Xu          , Xu          , Xu          , Uu^Vu       , Uu          , Xu          , Uu          , Uu          , Uu          , Uu          , Xu          , Uu          , _off^_usr   
_off^_usr   , Xu          , Xu          , Xu          , Xu          , Uu          , Uu          , Xu          , Uu          , Uu          , Uu          , Uu          , Uu          , Xu          , Xu          , Xu          , Uu          , Xu          , Xu          , Uu^Vu       , Xu          , _off^_usr   
_off^_usr   , Xu          , Xu          , Xu          , Uu^Vu       , Uu          , Uu          , Xu          , Xu          , Xu          , Xu          , Xu          , Xu          , Xu          , Xu          , Xu          , Uu          , Xu          , Xu          , Xu          , Xu          , _off^_usr   
_off^_usr   , Xu          , Xu          , Xu          , Uu          , Xu          , Uu          , Xu          , Xu          , Xu          , Xu          , Xu          , Xu          , Xu          , Xu          , Xu          , Uu          , Xu          , Uu          , Uu          , Uu          , _off^_usr   
_off^_usr   , Xu          , Uu          , Uu          , Uu          , Xu          , Uu          , Xu          , Xu          , Xu          , Uu          , Xu          , Xu          , Xu          , Uu^Vu       , Xu          , Uu          , Xu          , Uu          , Xu          , Uu          , _off^_usr   
_off^_usr   , Uu          , Xu          , Xu          , Uu          , Xu          , Uu          , Xu          , Xu          , Uu          , Uu          , Uu          , Xu          , Xu          , Uu          , Xu          , Uu          , Xu          , Uu          , Xu          , Uu          , _off^_usr   
_off^_usr   , Uu          , Xu          , Uu^Vu       , Xu          , Xu          , Uu          , Xu          , Uu^Vu       , Uu          , Xu          , Uu          , Uu          , Xu          , Uu          , Xu          , Xu          , Uu          , Xu          , Xu          , Uu          , _off^_usr   
_off^_usr   , Uu          , Xu          , Xu          , Xu          , Xu          , Uu          , Xu          , Xu          , Uu          , Uu          , Xu          , Xu          , Uu          , Xu          , Uu          , Xu          , Xu          , Xu          , Xu          , Uu          , _off^_usr   
_off^_usr   , Uu          , Uu^Vu       , Uu          , Xu          , Xu          , Uu          , Uu          , Xu          , Xu          , 1 Kud       , Xu          , Xu          , Uu          , Xu          , Xu          , Uu          , Uu          , Uu          , Xu          , Uu          , _off^_usr   
_off^_usr   , Xu          , Xu          , Uu          , Xu          , Uu^Vu       , Uu          , Uu^Vu       , Xu          , Cud         , Gg          , Cud         , Xu          , Uu          , Uu          , Uu          , Xu          , Uu          , Xu          , Uu          , Xu          , _off^_usr   
_off^_usr   , _off^_usr   , _off^_usr   , _off^_usr   , _off^_usr   , _off^_usr   , _off^_usr   , _off^_usr   , _off^_usr   , _off^_usr   , _off^_usr   , _off^_usr   , _off^_usr   , _off^_usr   , _off^_usr   , _off^_usr   , _off^_usr   , _off^_usr   , _off^_usr   , _off^_usr   , _off^_usr   , _off^_usr   
