Xu, Xu, Xu, Xu, Xu, Xu, Xu, Xu, Xu, Xu, Xu, Xu, Xu, Xuf, Xu, Xu, Xuf, Xu, Xu, Xu, Xu, Xu, Xu, Xu, Xu, Xu, Xu, Xu, Xu, Xu, Xu
Xu, Xu, Xu, Xu, Xu, Xu, Xu, Xu, Xu, Xu, Xu, Xu, Uh^Em, Uu^Em, Uh^Dr, Xu, Uh, Xu, Uu^Em, Ur^Qhu, Ur^Em, Xu, Cud^Es, Xu, Xur, Xu, Xu, Xu, Xu, Xu, Xu
Xu, Xu, Xu, Xu, Xu, Xu, Xu, Xu, Xu, Xu, Xu, Uu^Em, Xu, Xu, Uu, Ur^Em, Ur^Em, Ur^Es, Xu, Xu, Xu, Uu, Cud, Cud^Es, Xur, Xuf, Xu, Xu, Xu, Xu, Xu
Xu, Xu, Xu, Xu, Xu, Xu, Xu, Xu, Xu, Xu, Xu, Uh^Dr, Xu, Uh^Em, Xu, Xu, Xu, Xu, Xur, Xur, Ur^Em, Xu, Ur^Qhu, Cud^Em, Cud^Em, 2 Kud, Xu, Xu, Xu, Xu, Xu
Xu, Xu, Xu, Xu, Xu, Xu, Xu, Xu, Xu, Xu, Xu, Uu^Qhu, Uu^Qhu, Ur^Eb, Uu^Vud, Xu, Uu^Vud, Xu, Ur^Qhu, Ur^Qhu, Xu, Ur^Em, Xu, Cud, Cud^Es, Cud, Xu, Xu, Xu, Xu, Xu
Xu, Xu, Xu, Xu, Xu, Xu, Xu, Xu, Xu, Xu, Xu, Xu, Xu, Ur^Em, Xu, Xu, Xu, Ur^Qhu, Xur, Xu^Dr, Xu, Xu, Xur, Xu, Ur^Em, Cud^Es, Xu, Xu, Xu, Xu, Xu
Xu, Xu, Xu, Xu, Xu, Xu, Xu, Xu, Xu, Xu, Xu, Xu, Xur, Qxu^Bs|, Qxu, Xu, Xu, Ur, Uh, Xu, Xu, Xu, Uh, Ur^Qhu, Uu^Vud, Xur, Xu, Xu, Xu, Xu, Xu
Xu, Xu, Xu, Xu, Xu, Xu, Xu, Xu, Xu, Xu, Xu, Xur, Uu, Ur^Em, Ur^Em, Qxu, Qxu^Bs/, Ur, Xu, Xu, Xur, Xur, Ur^Em, Ur, Xu, Xu, Xu, Xu, Xu, Xu, Xu
Xu, Xu, Xu, Xu, Xu, Xu, Xu, Xu, Xuf, Xu, Ww, Uh, Xu, Uh^Em, Ur^Em, Ur^Em, Uh, Qxu, Xu, Xuf, Xu, Ur^Em, Xu, Uh^Em, Xu, Xu, Xu, Xu, Xu, Xu, Xu
Xu, Xu, Xu, Xu, Xu, Xu, Xu, Xu, Uh, Xu, Ur^Em, Tb, Ur^Em, Uh, Uu^Vud, Ur, Ur^Em, Qxu, Ur^Em, Uu^Vud, Uu, Ur^Qhu, Uh^Em, Uh^Dr, Xu, Xu, Xu, Xu, Xu, Xu, Xu
Xu, Xu, Xu, Xu, Xu, Xu, Xu, Uu^Vud, Ur, Uu^Em, Xu, Ur^Em, Uh^Em, Uu, Xu, Uu^Em, Xu, Qxu^Bs\, Ur^Em, Uh, Xu, Xur, Xu, Xu, Xu, Xu, Xu, Xu, Xu, Xu, Xu
Xu, Xu, Xuf, Xu, Xu, Xu, Xu, Xur, Ur, Ww, Xur, Uu, Xur, Xu, Xu, Xu, Qxu, Qxu, Tb, Xur, Xu, Xu, Xu, Xu, Xu, Xu, Xu, Xu, Xu, Xu, Xu
Xu, Xu, Uh, Xu, Xu, Ww, Uh^Em, Uu^Dr, Ur^Es, Uh, Uu^Em, Uh, Xur, Xu, Xu, Xu, Xu, Xu, Xu, Xu, Xu, Xu, Xu, Xu, Xu, Xu, Xu, Xu, Xu, Xu, Xu
Xu, Uu^Vud, Uh^Em, Xur, Ur^Em, Uu, Xu, Uu^Vud, Xu, Uu^Em, Ww, Xu, Xu, Xu, Xu, Xu, Xu, Xu, Xu, Xu, Xu, Xu, Xu, Xu, Xu, Xu, Xu, Xu, Xu, Xu, Xu
Xu, Uu^Em, Ur^Eb, Ur, Xu, Ur, Wwr, Xu, Xu, Uu, Xur, Xur, Xur, Xuf, Xu, Xu, Xur, Xu, Xu, Xu, Xu, Xu, Xu, Xu, Xu, Xu, Xu, Xu, Xu, Xu, Xu
Xu, Uh, Uu^Vud, Wwr, Xu, Uh, Xu, Uu^Em, Ur^Qhu, Uu, Uu, Uu^Qhh, Uh, Uu^Vud, Ww, Xu, Uu^Qhh, Ww, Xu, Xu, Xu, Xu, Xu, Xu, Xu, Xu, Xu, Xu, Xu, Xu, Xu
Xu, Xu, Xu, Xu, Ww, Uh^Em, Tb^Qhh, Ur^Em, Xu, Xu, Xu, Ur^Em, Ur, Ur^Eb, Uu, Uu^Em, Xu, Uu^Em, Uu^Em, Xur, Xu, Xu, Xuf, Xu, Xur, Xu, Xu, Xu, Xu, Xu, Xu
Xu, Xu, Xu, Xu, Xu, Xu, Uu^Dr, Uu, Xu, Xu, Xu, Uu^Qhh, Uu^Vud, Uh, Xu, Xu, Ww, Xu, Uu^Qhh, Ww, Xu, Xu, Ww, Xu, Uu^Qhu, Xur, Xu, Xu, Xu, Xu, Xu
Xu, Xu, Xu, Xur, Xur, Uh, Uu^Qhh, Uu^Qhh, Xu, Xu, Xu, Xu, Xu, Xu, Xu, Xu, Uu^Em, Uu^Qhh, Xu, Xu, Xur, Xu, Uu^Qhh, Uu^Em, Uu^Em, Xu, Xu, Xu, Xu, Xu, Xu
Xu, Xu, Xu, Xu, Cud^Em, Cud^Em, Uu^Em, Ur^Em, Xu, Xur, Xur, Xu, Xu, Xu, Xu, Xu, Uu^Dr, Xu, Xur, Uu^Qhh, Ww, Uu^Qhh, Xu, Wo, Xu, Xuf, Xur, Xu, Xu, Xu, Xu
Xu, Xu, Xu, Xu, Kud, Xu, Uh, Ur, Uh, Uh^Em, Uu^Vud, Xu, Xu, Xuf, Xu, Wo, Uh^Dr, Xu, Uu^Em, Wo, Xu, Xu, Ww, Ww, Tb^Qhh, Uu^Em, Wo, Xu, Xu, Xu, Xu
Xu, Xu, Xu, Ww, Cud^Em, Xu, Uu^Em, Ur, Xu, Ww, Xu, Xu, Xur, Xur, Uu^Dr, Uu^Em, Wo, Uu, Uh, Uu^Dr, Xu, Xu, Ww^Es, Xu, Uu^Qhh, Xu, Xu, Xu, Xu, Xu, Xu
Xu, Xu, Xu, Xu, Xu, Cud, Uu, Uh, Uh^Dr, Xu, Xur, Xu, Uu^Em, Ww, Uh, Tb^Qhh, Xu, Xu, Xu, Xu, Xu, Xu, Xuf, Xu, Wo, Uu^Dr, Xu, Xu, Xu, Xu, Xu
Xu, Xu, Xu, Xu, Xu, Xu, Xu, Ur, Uu^Em, Xu, Uu^Edt, Tb^Dr, Wo, Uu, Xu, Uu^Qhh, Wo, Wo, Wo, Xur, Xu, Xu, Xu, Uu^Edt, Wo, Wo, Xur, Xu, Xu, Xu, Xu
Xu, Xu, Xu, Xu, Xu, Xu, Xur, Ur^Em, Uu, Ww, Uu^Qhh, Uh, Xu, Xu, Xu, Xu, Xu, Xu, Xu, Wo, Xu, Xuf, Xur, Wwr, Wo, Uh, Ww, Xur, Xu, Xu, Wo
Xu, Xu, Xur, Xuf, Xu, Xur, Wo, Uh, Uh, Uu^Qhh, Xu, Xu, Xu, Xu, Xu, Xu, Xu, Xu, Xu, Wo, Wo, Wo, Wo, Xur, Xu, Uu^Qhh, Ww^Vm, Uu^Qhh, Ww, Xu, Wo
Xu, Xu, Uu^Em, Uu^Dr, Ww^Es, Ww, Xu, Xu, Ur, Uu^Dr, Xu, Xu, Xu, Xu, Xu, Xu, Tb^Qhh, Xu, Qxua, Qxu, Qxu, Xu, Xu, Wo, Uu^Qhh, Uu^Qhh, Xu, Ww, Chw^Es, Chw^Es, Chw
Wo, Wo, Uh, Uu^Qhh, Xu, Xu, Xu, Xu, Uu^Qhh, Uu^Em, Xu, Xu, Xu, Xu, Xu, Xu, Tb^Qhh, Qxua, Tb^Qhh, Qxua, Qxua, Xu, Tb^Qhh, Xu, Xu, Xu, Ww^Vm, Uu^Es, Chw^Es, 3 Khw, Wo
Ww, Ww, Xu, Xu, Xu, Xu, Ww, Ur^Em, Uu^Vu, Ww, Xu, Xu, Xu, Xu, Xu, Xu, Xu, Qxua, Xu, Qxua, Xu, Qxua, Xu, Xu, Xu, Xu, Uh, Ww, Chw^Es, Wo, Wo
Xu, Xu, Xu, Xu, Xu, Xu, Uu^Dr, Ur, Xu, Xu, Xu, Xu, Xu, Xu, Xu, Xu, Xu, Xu, Xu, Xu, Xu, Xu, Xu, Xu, Xu, Uu^Em, Xu, Uu^Dr, Xu, Wo, Wo
Xu, Xu, Xu, Xu, Xu, Xur, Uu, Uu^Qhh, Xu, Xu, Xu, Xu, Xu, Xu, Xu, Xu, Xu, Xu, Xu, Xu, Xu, Xu, Xu, Xu, Xu, Wo, Xu, Xu, Xu, Xu, Xu
Xu, Xu, Xu, Xu, Xur, Cud^Em, Cud^Em, Cud, Xu, Xu, Xu, Xu, Xu, Xu, Xu, Xu, Xu, Xu, Xu, Xu, Xu, Xu, Xu, Xu, Xu, Xu, Xu, Xu, Xu, Xu, Xu
Xu, Xu, Xu, Xu, Cud^Em, Cud, Cud^Em, Xu, Xu, Xu, Xu, Xu, Xu, Xu, Xu, Xu, Xu, Xu, Xu, Xu, Xu, Xu, Xu, Xu, Xu, Xu, Xu, Xu, Xu, Xu, Xu
Xu, Xu, Xur, Xur, Ww, 1 Kud, Ww, Xu, Xu, Xu, Xu, Xu, Xu, Xu, Xu, Xu, Xu, Xu, Xu, Xu, Xu, Xu, Xu, Xu, Xu, Xu, Xu, Xu, Xu, Xu, Xu
Xu, Xu, Ww, Ww, Ww, Ww, Xu, Xu, Xu, Xu, Xu, Xu, Xu, Xu, Xu, Xu, Xu, Xu, Xu, Xu, Xu, Xu, Xu, Xu, Xu, Xu, Xu, Xu, Xu, Xu, Xu
