Xu, Xu, Xu, Xu, Xu, Xu, Xu, Xu, Xu, Xu, Xu, Xu, Xu, Xuf, Xu, Xu, Xuf, Xu, Xu, Xu, Xu, Xu, Xu, Xu, Xu, Xu, Xu, Xu, Xu, Xu, Xu
Xu, Xu, Xu, Xu, Xu, Xu, Xu, Xu, Xu, Xu, Xu, Xu, Uh^Em, Uu^Em, Uh^Dr, Xu, Uh, Xu, Uu^Em, Ur^Qhu, Ur^Em, Xu, Cud^Es, Xu, Xur, Xu, Xu, Xu, Xu, Xu, Xu
Xu, Xu, Xu, Xu, Xu, Xu, Xu, Xu, Xu, Xu, Xu, Uu^Em, Xu, Xu, Uu, Ur^Em, Ur^Em, Ur^Es, Xu, Xu, Xu, Uu, Cud, Cud^Es, Xur, Xuf, Xu, Xu, Xu, Xu, Xu
Xu, Xu, Xu, Xu, Xu, Xu, Xu, Xu, Xu, Xu, Xu, Uh^Dr, Xu, Uh^Em, Xu, Xu, Xu, Xu, Xur, Xur, Ur^Em, Xu, Ur^Qhu, Cud^Em, 1 Cud^Em, Kud, Xu, Xu, Xu, Xu, Xu
Xu, Xu, Xu, Xu, Xu, Xu, Xu, Xu, Xu, Xu, Xu, Uu^Qhu, Uu^Qhu, Ur^Eb, Uu^Vud, Xu, Uu^Vud, Xu, Ur^Qhu, Ur^Qhu, Xu, Ur^Em, Xu, Cud, Cud^Es, Cud, Xu, Xu, Xu, Xu, Xu
Xu, Xu, Xu, Xu, Xu, Xu, Xu, Xu, Xu, Xu, Xu, Xu, Xu, Ur^Em, Xu, Xu, Xu, Ur^Qhu, Xur, Xu^Dr, Xu, Xu, Xur, Xu, Ur^Em, Cud^Es, Xu, Xu, Xu, Xu, Xu
Xu, Xu, Xu, Xu, Xu, Xu, Xu, Xu, Xu, Xu, Xu, Xu, Xur, Qxu^Bs|, Qxu, Xu, Xu, Ur, Uh, Xu, Xu, Xu, Uh, Ur^Qhu, Uu^Vud, Xur, Xu, Xu, Xu, Xu, Xu
Xu, Xu, Xu, Xu, Xu, Xu, Xu, Xu, Xu, Xu, Xu, Xur, Wo, Wo, Wo, Qxu, Qxu^Bs/, Ur, Xu, Xu, Xur, Xur, Ur^Em, Ur, Xu, Xu, Xu, Xu, Xu, Xu, Xu
Xu, Xu, Xu, Xu, Xu, Xu, Xu, Xu, Xuf, Xu, Wo, Wo, Xu, Wo, Wo, Wo, Wo, Qxu, Xu, Xuf, Xu, Ur^Em, Xu, Uh^Em, Xu, Xu, Xu, Xu, Xu, Xu, Xu
Xu, Xu, Xu, Xu, Xu, Xu, Xu, Xu, Wo, Xu, Wo, Wo, Wo, Wo, Wo, Wo, Wo, Qxu, Ur^Em, Uu^Vud, Uu, Ur^Qhu, Uh^Em, Uh^Dr, Xu, Xu, Xu, Xu, Xu, Xu, Xu
Xu, Xu, Xu, Xu, Xu, Xu, Xu, Wo, Wo, Wo, Xu, Wo, Wo, Wo, Xu, Wo, Xu, Qxu^Bs\, Ur^Em, Uh, Xu, Xur, Xu, Xu, Xu, Xu, Xu, Xu, Xu, Xu, Xu
Xu, Xu, Xuf, Xu, Xu, Xu, Xu, Xur, Wo, Wo, Xur, Wo, Xur, Xu, Xu, Xu, Qxu, Qxu, Tb, Xur, Xu, Xu, Xu, Xu, Xu, Xu, Xu, Xu, Xu, Xu, Xu
Xu, Xu, Wo, Xu, Xu, Wo, Wo, Wo, Wo, Wo, Wo, Wo, Xur, Xu, Xu, Xu, Xu, Xu, Xu, Xu, Xu, Xu, Xu, Xu, Xu, Xu, Xu, Xu, Xu, Xu, Xu
Xu, Wo, Wo, Xur, Wo, Wo, Xu, Wo, Xu, Wo, Wo, Xu, Xu, Xu, Xu, Xu, Xu, Xu, Xu, Xu, Xu, Xu, Xu, Xu, Xu, Xu, Xu, Xu, Xu, Xu, Xu
Xu, Wo, Wo, Wo, Xu, Wo, Wo, Xu, Xu, Wo, Xur, Xur, Xur, Xuf, Xu, Xu, Xur, Xu, Xu, Xu, Xu, Xu, Xu, Xu, Xu, Xu, Xu, Xu, Xu, Xu, Xu
Xu, Wo, Wo, Wo, Xu, Wo, Xu, Wo, Wo, Wo, Wo, Wo, Wo, Wo, Wo, Xu, Wo, Wo, Xu, Xu, Xu, Xu, Xu, Xu, Xu, Xu, Xu, Xu, Xu, Xu, Xu
Xu, Xu, Xu, Xu, Wo, Wo, Wo, Wo, Xu, Xu, Xu, Wo, Wo, Wo, Wo, Wo, Xu, Wo, Wo, Xur, Xu, Xu, Xuf, Xu, Xur, Xu, Xu, Xu, Xu, Xu, Xu
Xu, Xu, Xu, Xu, Xu, Xu, Wo, Wo, Xu, Xu, Xu, Wo, Wo, Wo, Xu, Xu, Wo, Xu, Wo, Wo, Xu, Xu, Wo, Xu, Wo, Xur, Xu, Xu, Xu, Xu, Xu
Xu, Xu, Xu, Xur, Xur, Wo, Wo, Wo, Xu, Xu, Xu, Xu, Xu, Xu, Xu, Xu, Wo, Wo, Xu, Xu, Xur, Xu, Wo, Wo, Wo, Xu, Xu, Xu, Xu, Xu, Xu
Xu, Xu, Xu, Xu, Wo, Wo, Wo, Wo, Xu, Xur, Xur, Xu, Xu, Xu, Xu, Xu, Wo, Xu, Xur, Wo, Wo, Wo, Xu, Wo, Xu, Xuf, Xur, Xu, Xu, Xu, Xu
Xu, Xu, Xu, Xu, Wo, Xu, Wo, Wo, Wo, Wo, Wo, Xu, Xu, Xuf, Xu, Wo, Wo, Xu, Wo, Wo, Xu, Xu, Wo, Wo, Wo, Wo, Wo, Xu, Xu, Xu, Xu
Xu, Xu, Xu, Wo, Wo, Xu, Wo, Wo, Xu, Wo, Xu, Xu, Xur, Xur, Wo, Wo, Wo, Wo, Wo, Wo, Xu, Xu, Ww^Es, Xu, Wo, Xu, Xu, Xu, Xu, Xu, Xu
Xu, Xu, Xu, Xu, Xu, Wo, Wo, Wo, Wo, Xu, Xur, Xu, Wo, Wo, Wo, Wo, Xu, Xu, Xu, Xu, Xu, Xu, Xuf, Xu, Wo, Wo, Xu, Xu, Xu, Xu, Xu
Xu, Xu, Xu, Xu, Xu, Xu, Xu, Wo, Wo, Xu, Wo, Wo, Wo, Wo, Xu, Wo, Wo, Wo, Wo, Xur, Xu, Xu, Xu, Wo, Wo, Wo, Xur, Xu, Xu, Xu, Xu
Xu, Xu, Xu, Xu, Xu, Xu, Xur, Wo, Wo, Wo, Wo, Wo, Xu, Xu, Xu, Xu, Xu, Xu, Xu, Wo, Xu, Xuf, Xur, Wo, Wo, Wo, Wo, Xur, Xu, Xu, Wo
Xu, Xu, Xur, Xuf, Xu, Xur, Wo, Wo, Wo, Wo, Xu, Xu, Xu, Xu, Xu, Xu, Xu, Xu, Xu, Wo, Wo, Wo, Wo, Xur, Xu, Wo, Ww^Vm, Wo, Wo, Xu, Wo
Xu, Xu, Wo, Wo, Ww^Es, Wo, Xu, Xu, Wo, Wo, Xu, Xu, Xu, Xu, Xu, Xu, Tb^Qhh, Xu, Qxua, Qxu, Qxu, Xu, Xu, Wo, Wo, Wo, Xu, Wo, Chw^Es, Chw^Es, Chw
Wo, Wo, Wo, Wo, Xu, Xu, Xu, Xu, Wo, Wo, Xu, Xu, Xu, Xu, Xu, Xu, Tb^Qhh, Qxua, Tb^Qhh, Qxua, Qxua, Xu, Tb^Qhh, Xu, Xu, Xu, Ww^Vm, Wo, Chw^Es, Khw, Wo
Wo, Wo, Xu, Xu, Xu, Xu, Wo, Wo, Wo, Wo, Xu, Xu, Xu, Xu, Xu, Xu, Xu, Qxua, Xu, Qxua, Xu, Qxua, Xu, Xu, Xu, Xu, Wo, Wo, Chw^Es, Wo, Wo
Xu, Xu, Xu, Xu, Xu, Xu, Wo, Wo, Xu, Xu, Xu, Xu, Xu, Xu, Xu, Xu, Xu, Xu, Xu, Xu, Xu, Xu, Xu, Xu, Xu, Wo, Xu, Wo, Xu, Wo, Wo
Xu, Xu, Xu, Xu, Xu, Xur, Wo, Wo, Xu, Xu, Xu, Xu, Xu, Xu, Xu, Xu, Xu, Xu, Xu, Xu, Xu, Xu, Xu, Xu, Xu, Wo, Xu, Xu, Xu, Xu, Xu
Xu, Xu, Xu, Xu, Xur, Wo, Wo, Wo, Xu, Xu, Xu, Xu, Xu, Xu, Xu, Xu, Xu, Xu, Xu, Xu, Xu, Xu, Xu, Xu, Xu, Xu, Xu, Xu, Xu, Xu, Xu
Xu, Xu, Xu, Xu, Wo, Wo, Wo, Xu, Xu, Xu, Xu, Xu, Xu, Xu, Xu, Xu, Xu, Xu, Xu, Xu, Xu, Xu, Xu, Xu, Xu, Xu, Xu, Xu, Xu, Xu, Xu
Xu, Xu, Xur, Xur, Wo, Wo, Wo, Xu, Xu, Xu, Xu, Xu, Xu, Xu, Xu, Xu, Xu, Xu, Xu, Xu, Xu, Xu, Xu, Xu, Xu, Xu, Xu, Xu, Xu, Xu, Xu
Xu, Xu, Ww, Wo, Wo, Wo, Xu, Xu, Xu, Xu, Xu, Xu, Xu, Xu, Xu, Xu, Xu, Xu, Xu, Xu, Xu, Xu, Xu, Xu, Xu, Xu, Xu, Xu, Xu, Xu, Xu
