border_size=1
usage=map

Ms          , Ms          , Ms          , Ms          , Ms          , Ms          , Ms          , Gg          , Ha          , Gg          , Hh          , Gg          , Gg          , Gg          , Gg          , Gg          , Gg          , Gg          , Gg          , Gg          , Gg          , Gg          , Gg          , Gg          , Gg          , Gg          , Gg          , Gg          , Gg          , Gg          , Gg          , Gg          , Gg          , Gg          , Gg          , Gg          , Gg          , Gg          
Ms          , Ms          , Ms          , Ms          , Ms          , Ms          , Ms          , Ha          , Ha          , Ha          , Hh          , Hh          , Hh          , Gg          , Gg          , Gg^Vc       , Aa          , Gg          , Aa          , Gg          , Gg          , Gg          , Gg          , Gg^Vo       , Gg          , Gg          , Gg          , Gg          , Gg          , Gg          , Gg          , Aa          , Aa          , Aa          , Gg          , Gg          , Gg^Vc       , Gg          
Ms          , Ms          , Ms          , Ms          , Ms          , Ms          , Ha          , Ha          , Ha          , Ha          , Hh          , Hh          , Hh^Fmw      , Hh^Fmw      , Gg          , Aa          , Aa          , Aa          , Aa          , Aa          , Aa          , Gg          , Gg          , Gg          , Gg          , Gg          , Gg          , Gg          , Aa          , Aa          , Aa^Voa      , Aa          , Gg          , Gg          , Gg          , Gg          , Gg          , Gg          
Ms          , Ms          , Ms          , Aa          , Aa          , Aa          , Ha          , Ha^Voa      , Ha          , Hh          , Hh          , Hh          , Hh          , Hh          , Gg          , Gg          , Gg          , Gg          , Gg          , Gg          , Gg          , Aa          , Gg          , Gg          , Gg          , Gg          , Gg          , Aa          , Gg          , Aa          , Gg          , Aa          , Gg          , Gg          , Gg          , Gg          , Gg          , Gg          
Ms          , Ms          , Ms          , Ms          , Aa          , Aa          , Hh          , Ha          , Hh          , Hh          , Hh          , Hh          , Hh          , Hh          , Gg          , Gg          , Gg          , Gg^Vo       , Gg          , Gg          , Gg          , Gg          , Gg          , Gg          , Gg          , Gg          , Gg          , Gg          , Gg          , Gg          , Gg          , Gg          , Hh          , Hh          , Gg          , Gg          , Gg          , Gg          
Ms          , Ms          , Ms          , Ms          , Hh          , Hh          , Hh          , Hh          , Hh          , Hh          , Hh          , Hh          , Gg          , Gg          , Gg          , Hh          , Hh          , Gg          , Gg          , Gg          , Gg          , Gg          , Hh          , Gg          , Gg          , Gg          , Gg          , Gg          , Gg          , Gg          , Gg          , Hh          , Hh          , Hh          , Gg          , Gg          , Gg          , Gg          
Ms          , Ms          , Ms          , Aa          , Hh^Vo       , Hh          , Hh          , Hh^Fmw      , Hh          , Hh          , Hh          , Gg          , Gg          , Gg          , Hh          , Mm          , Gg          , Gg          , Gg          , Gg          , Hh          , Gg          , Gg          , Hh          , Gg          , Gg          , Gg          , Gg^Vo       , Gg          , Gg          , Gg          , Gg          , Gg          , Hh          , Gg          , Gg          , Gg          , Gg          
Ms          , Ms          , Ms          , Hh          , Hh          , Hh          , Hh^Fmw      , Hh^Fmw      , Hh          , Hh          , Gg          , Gg          , Gg          , Gg          , Gg          , Hh          , Gg          , Gg          , Hh^Vo       , Hh          , Hh          , Hh          , Co          , Hh          , Hh          , Gg          , Hh          , Gg          , Gg          , Gg          , Gg          , Gg          , Gg          , Gg          , Gg          , Gg          , Gg^Vo       , Gg          
Ms          , Ms          , Ms          , Hh          , Hh          , Hh^Fmw      , Hh^Fmw      , Hh          , Hh          , Hh          , Gg          , Gg^Vo       , Gg          , Gg          , Gg          , Gg          , Gg          , Hh          , Hh          , Hh          , Co          , Co          , Co          , 3 Ko        , Mm          , Hh          , Gg          , Hh          , Hh          , Gg          , Gg          , Gg          , Gg          , Gg          , Gg          , Gg          , Gg          , Gg          
Ms          , Ms          , Ms          , Hh          , Hh          , Hh          , Hh          , Hh          , Hh          , Hh          , Gg          , Gg          , Rd          , Gg          , Gg          , Gg          , Gg          , Hh          , Hh          , Gg          , Co          , Ko          , Hh          , Co          , Co          , Hh          , Gg          , Gg          , Hh          , Gg          , Gg          , Gg          , Gg          , Gg          , Gg          , Gg          , Gg          , Gg          
Ms          , Ms          , Ms          , Hh          , Hh          , Hh          , Hh          , Hh          , Hh          , Hh          , Gg          , Gg          , Gg          , Gg          , Gg          , Gg          , Gg          , Gg          , Hh          , Hh          , Hh          , Co          , Hh          , Hh          , Wwr         , Hh          , Hh          , Gg          , Hh          , Gg          , Gg          , Gg          , Gg          , Gg^Vo       , Gg          , Gg          , Gg          , Gg          
Ms          , Ms          , Ms          , Ms          , Hh          , Hh^Vo       , Hh          , Hh          , Gg          , Gg          , Gg          , Gg          , Gg          , Rd          , Gg          , Gg          , Ww          , Ww          , Ww          , Hh          , Ww          , Wwr         , Wwr         , Ww          , Ww          , Ww          , Wwr         , Hh          , Ww          , Gg          , Ww          , Ww          , Ww          , Ww          , Ww          , Gg          , Gg          , Gg          
Ms          , Ms          , Ms          , Ms          , Hh          , Hh          , Hh          , Hh          , Hh          , Gg          , Gg          , Gg          , Gg          , Gg          , Ww          , Ww          , Ww          , Ww          , Ww          , Ww          , Ww          , Ww          , Gg          , Ww          , Gg          , Ww          , Ww          , Ww          , Ww          , Ww          , Ww          , Ww          , Gg          , Ww          , Ww          , Ww          , Ww          , Ww          
Ms          , Ms          , Ms          , Ms          , Aa          , Hh          , Hh          , Hh          , Hh          , Hh          , Hh          , Gg          , Gg          , Ww          , Ww          , Ww          , Gg          , Gg          , Gg          , Gg          , Gg          , Gg          , Gg          , Gg          , Gg          , Gg          , Gg          , Gg          , Gg          , Ww          , Gg          , Gg          , Gg          , Gg          , Gg          , Gg          , Gg          , Ww          
Wo          , Ms          , Ms          , Ms          , Ai          , Aa          , Ai          , Hh          , Ww          , Hh          , Ww          , Hh          , Ww          , Ww          , Ww          , Gg          , Rd          , Gg          , Gg^Vc       , Gg          , Gg          , Gg          , Gg^Vo       , Gg          , Gg          , Gg          , Gg          , Gg          , Gg          , Gg          , Gg          , Gg          , Gg          , Gg          , Gg          , Gg          , Gg          , Gg          
Ms          , Wo          , Wo          , Wo          , Wo          , Ai          , Wo          , Ww          , Ww          , Ww          , Ww          , Ww          , Ww          , Ww          , Gg          , Gg          , Rd          , Gg          , Gg          , Gg          , Gg          , Gg          , Gg          , Gg          , Gg          , Rd          , Rd          , Gg          , Gg          , Gg          , Gg          , Gg          , Gg          , Gg          , Gg          , Gg          , Gg          , Gg          
Ms          , Ms          , Ms          , Ha          , Ha          , Wo          , Ha          , Ww          , Hh          , Ww          , Hh          , Hh          , Gg          , Gg          , Gg          , Gg          , Rd          , Gg          , Gg          , Gg          , Aa^Fma      , Aa          , Aa          , Gg          , Gg          , Gg          , Gg          , Rd          , Rd          , Gg          , Gg          , Gg          , Gg          , Gg^Vo       , Gg          , Gg          , Gg          , Gg          
Ms          , Ms          , Ha^Vca      , Aa          , Aa          , Ha          , Aa          , Hh          , Hh^Vc       , Hh          , Hh          , Hh          , Gg          , Gg          , Gg          , Gg          , Gg          , Gg          , Gg          , Aa^Fma      , Ha^Fma      , Ha^Fma      , Ha^Fma      , Aa^Fma      , Aa^Fma      , Gg          , Gg          , Gg          , Rd          , Gg          , Gg          , Gg          , Gg          , Gg          , Gg          , Gg          , Gg          , Gg          
Ms          , Ms          , Aa          , Aa          , Gg          , Aa          , Gg          , Hh          , Hh          , Hh          , Hh          , Hh          , Gg          , Gg          , Gg          , Gg          , Gg          , Gg          , Gg          , Ha^Voa      , Ha^Fma      , Hh^Fmw      , Hh^Fmw      , Ha^Fma      , Gs^Fmw      , Gg          , Gg          , Gg          , Rd          , Gg          , Gg          , Gg          , Gg          , Gg          , Ai          , Gg          , Gg          , Gg          
Mm          , Ms          , Mm          , Gg          , Hh          , Hh          , Hh          , Hh          , Hh          , Hh          , Hh          , Hh          , Gg          , Gg          , Gg          , Gg          , Gg          , Gg          , Aa          , Ha          , Gg          , Hh^Fmw      , Hh^Fmw      , Hh^Fmw      , Hh          , Gg          , Gg          , Gg          , Gg          , Rd          , Gg          , Gg          , Gg          , Ai          , Ai          , Ai          , Ai          , Gg          
Mm          , Mm^Vc       , Mm          , Gg          , Gg          , Hh          , Hh          , Hh^Fmw      , Hh^Vo       , Hh          , Hh          , Hh          , Gg          , Gg          , Gg          , Rd          , Rd          , Gg          , Gg          , Aa          , Gg          , Hh          , Gg          , Hh          , Gg          , Gg          , Gg          , Gg          , Gg          , Rd          , Gg          , Gg          , Gg          , Ai          , Ai          , Ai          , Ai          , Ai          
Mm          , Mm          , Ms          , Mm          , Hh          , Hh          , Hh          , Hh^Fmw      , Hh^Fmw      , Hh          , Hh          , Hh          , Gg          , Gg          , Gg          , Gg          , Gg          , Rd          , Rd          , Gg          , Gg          , Gg          , Gg          , Gg          , Rd          , Gg          , Gg          , Gg          , Gg          , Rd          , Gg          , Gg          , Gg          , Ww          , Ww          , Ai          , Ww          , Ww          
Ms          , Ms          , Aa          , Aa          , Gg          , Hh          , Hh          , Hh          , Hh          , Hh          , Hh          , Gg          , Gg          , Gg          , Gg          , Gg          , Gg          , Gg          , Gg          , Gg          , Gg          , Gg          , Gg          , Rd          , Rd          , Gg          , Gg          , Gg          , Gg          , Rd          , Gg          , Gg          , Gg          , Gg          , Gg          , Ww          , Gg          , Gg          
Ai          , Ms          , Ww          , Aa          , Gg          , Hh          , Hh          , Hh          , Hh          , Hh          , Hh          , Gg          , Ww          , Gg          , Gg          , Gg          , Gg          , Gg          , Gg          , Gg          , Gg          , Gg          , Gg          , Gg          , Gg          , Gg          , Gg          , Gg          , Gg          , Rd          , Gg          , Gg          , Gg          , Gg          , Gg          , Gg          , Gg          , Gg          
Ai          , Ai          , Ww          , Ww          , Ww          , Ww          , Ww          , Ww          , Wwr         , Ww          , Ww          , Ww          , Ww          , Ww          , Wwr         , Gg          , Gg          , Gg          , Gg          , Gg          , Gg          , Gg          , Hh          , Hh          , Hh          , Ha          , Ha          , Gg          , Gg          , Rd          , Rd          , Gg          , Aa          , Gg          , Gg          , Gg          , Gg          , Gg          
Ms          , Ms          , Ms          , Ww          , Ha          , Ai          , Ww          , Ww          , Hh          , Ww          , Gg          , Ww          , Ww          , Ww          , Ww          , Gg          , Gg          , Gg          , Gg          , Rd          , Rd          , Gg          , Gg          , Gg          , Gg          , Hh          , Ha          , Ha          , Aa^Voa      , Aa          , Aa          , Aa          , Aa          , Gg          , Gg          , Gg          , Gg          , Gg          
Ms          , Ms          , Ms          , Ha          , Hh          , Hh          , Hh          , Hh          , Hh          , Hh          , Gg          , Gg          , Gg          , Gg          , Gg          , Ww          , Ww          , Gg          , Gg          , Gg          , Gg          , Gg          , Gg          , Gg          , Gg          , Gg          , Gg          , Aa          , Gg          , Aa          , Gg          , Rd          , Gg          , Aa          , Gg          , Gg          , Gg          , Gg          
Ms          , Ms          , Ms          , Hh          , Hh          , Hh          , Hh          , Hh^Vo       , Hh          , Hh          , Hh          , Gg          , Gg          , Gg          , Gg          , Gg          , Ww          , Ww          , Gg          , Gg          , Gg          , Gg          , Gg          , Gg          , Gg          , Gg          , Gg          , Gg          , Gg          , Gg          , Gg          , Rd          , Rd          , Gg          , Gg          , Gg          , Gg          , Gg          
Ms          , Ms          , Ms          , Hh          , Hh          , Hh          , Hh          , Hh          , Hh          , Hh          , Hh          , Hh          , Hh          , Gg          , Gg          , Gg          , Gg          , Ai          , Ai          , Gg          , Gg          , Gg          , Gg          , Gg          , Gg          , Gg          , Gg          , Gg          , Gg          , Gg          , Gg          , Gg          , Gg          , Rd          , Rd          , Gg          , Rd          , Rd          
Ms          , Ms          , Ha          , Hh          , Hh          , Hh          , Hh          , Hh          , Hh          , Hh          , Hh          , Hh          , Hh          , Gg          , Gg          , Gg          , Gg          , Gg          , Gg          , Ai          , Ww          , Gg          , Ww          , Gg          , Ww          , Gg          , Gg          , Gg          , Gg          , Gg          , Gg          , Gg          , Gg          , Gg          , Gg          , Rd          , Gg          , Gg          
Ms          , Ms          , Ha          , Ha          , Ha          , Ha          , Hh          , Hh          , Hh          , Hh          , Hh          , Hh          , Hh          , Gg          , Gg          , Gg          , Rd          , Rd          , Gg          , Gg          , Gg          , Ww          , Ww          , Ww          , Ww          , Ww          , Ww          , Ww          , Ww          , Gg          , Ww          , Ww          , Ww          , Ww          , Ww          , Gg          , Wwr         , Ww          
Ms          , Ms          , Ha          , Ha          , Ha          , Ha          , Hh          , Hh          , Hh          , Hh          , Hh          , Chr         , Chr         , Gg          , Gg          , Gg          , Gg          , Gg          , Gg          , Gg          , Gg          , Gg          , Gg          , Ww          , Gg          , Ww          , Ww          , Ww          , Ww          , Wwf         , Ww          , Ww          , Chw         , Ww          , Chr         , Ww          , Ww          , Ww          
Ms          , Ms          , Hh          , Hh          , Hh          , Hh          , Hh          , Hh          , Hh          , Chr         , Hh          , Hh          , Gg          , Gg          , Gg          , Rd          , Gg          , Gg          , Aa          , Gg          , Gg          , Gg          , Gg          , Gg          , Gg          , Gg          , Gg          , Ww          , Gg          , Gg          , Chr         , Chw         , 1 Khr       , Chr         , Gg          , Gg          , Chw         , Ww          
Ms          , Ms          , Hh          , Hh          , Mm          , Hh          , Chr         , Hh          , Chr         , Chr         , Chr         , Chr         , Gg          , Gg          , Gg          , Rd          , Gg          , Gg          , Gg          , Aa          , Aa          , Gg          , Aa          , Gg          , Gg          , Gg          , Gg          , Gg          , Gg          , Gg          , Gg          , Chr         , Gg          , Gg          , Gg          , Chr         , Gg          , Gg          
Ms          , Ms          , Ms          , Hh          , Mm          , Hh          , Hh          , Hh          , Hh          , 2 Khr       , Hh          , Gg          , Gg          , Gg          , Gg          , Rd          , Rd          , Gg          , Gg          , Gg          , Gg          , Aa          , Aa          , Aa          , Gg          , Gg          , Gg          , Gg          , Gg          , Gg          , Gg          , Gg          , Gg          , Gg          , Gg          , Gg          , Gg          , Gg          
Ms          , Ms          , Mm          , Mm          , Ha          , Mm          , Ha          , Hh          , Hh          , Hh          , Gg          , Gg          , Gg          , Gg          , Gg          , Gg^Vo       , Rd          , Gg          , Gg          , Gg          , Gg          , Gg          , Gg          , Gg          , Gg          , Gg^Vc       , Gg          , Gg          , Gg          , Gg          , Gg          , Gg          , Gg          , Gg          , Gg          , Gg          , Ha          , Ha          
Ms          , Ms          , Ms          , Ms          , Ms          , Ha          , Ha          , Ha          , Hh          , Hh          , Gg          , Gg          , Gg          , Gg          , Gg          , Rd          , Gg          , Gg          , Gg          , Gg          , Gg          , Gg          , Gg          , Gg          , Gg          , Gg          , Gg          , Gg          , Gg          , Gg          , Gg          , Gg          , Aa          , Aa          , Aa          , Ha          , Ha          , Ha          
