Ms, Ms, Ms, Ms, Ms, Ms, Ms, Ms, Ms, Ai, Ai, Ms, Ms, Ha, Ha^Fp, Ha^Fp, Ha^Fp, Ha, Ha^Fp, Hh, Aa, Gg, Gg, Gg^Fp, Hh^Fp, Gg, Hh^Fp, Gg^Fp, Gg^Fp, Gg, Gg, Gg^Fp, Rb, Gg, Gg^Fp, Gg, Gg^Fp, Gg^Fp
Ms, Ms, Ms, Ms, Ha, Ms, Ha, Ms, Ai, Ai, Ww, Ms, Ha, Ha^Fp, Hh^Fp, Ha^Fp, Hh^Fp, Ha, Hh, Ha^Fp, Aa^Fp, Hh, Hh^Fp, Gg^Fp, Gg^Fp, Gg, Gg, Gg^Fp, Gg^Fp, Gg^Fp, Gg^Fms, Gg^Fp, Rb, Gg^Fp, Gg, Gg^Vo, Gg^Fp, Gg^Fp
Ms, Ms, Ha, Ai, Ww, Ai, Ai, Ww, Ms, Ms, Ai, Ha, Ww, Ha, Ha, Aa, Aa^Fp, Hh^Fp, Hh, Aa, Gg, Gg^Fp, Gg, Hh, Gg, Gg^Efm, Gg, Gg, Gg, Gg^Fms, Gg^Fp, Gg^Fp, Rb^Fp, Gg^Es, Gg, Gg^Fp, Gg, Gg
Ms, Ms, Ms, Ai, Ww, Ww, Ww, Ha, Ms, Ms, Mm, Ww, Ha, Ww, Hh^Fp, Hh^Fp, Ha^Fp, Aa, Gg, Gg^Fp, Hh, Hh^Es, Gg^Vo, Re^Fp, Gg, Gg, Gg, Gg^Vo, Gg, Gg, Gg^Fp, Rb, Gg^Fp, Gg^Fms, Gg, Gg^Es, Gg^Fp, Gs^Fds
Ms, Ms, Ms, Ms, Ms, Ai, Ha, Ha, Ha, Ms, Ms, Hh, Hh^Fp, Ww, Aa, Hh^Fp, Gg^Fp, Hh^Fp, Hh, Gg^Fp, Gg^Fp, Gg^Es, Hh, Re, Re, Gg^Fp, Gg, Gg^Efm, Gg, Gg, Rb, Rb^Es, Re^Vo, Gg, Gg^Fp, Gg, Gg^Fds, Gs^Fds
Ms, Ms, Ms, Ms, Ms, Ai, Ms, Ms, Ms, Ha^Fp, Ha^Fp, Mm, Mm, Ww, Wo, Ww, Wo, Gg^Fp, Gg^Fp, Hh^Fp, Gg^Fp, Gg, Gg^Fp, Gg^Fms, Re^Es, Gg, Gg, Gg, Gg, Gg^Fp, Rb, Gg, Gg, Gg, Gg, Gg, Gg, Gg
Ai, Ms, Ms, Ms, Mm, Ms, Ms, Ms, Ms, Ha, Aa, Mm, Hh^Fp, Mm, Ha, Hh^Fp, Hh^Fp, Ww, Hh^Fp, Gg^Fp, Gg^Fp, Gg^Fp, Gg^Fp, Gg^Fp, Re, Gg^Fp, Gg, Gg^Efm, Rb, Rb, Gg, Gg^Qhh, Gg, Gg^Efm, Gg^Qhh, Gg, Gg^Fp, Gg^Fp
Ms, Ai, Ai, Ms, Ms, Ha, Ha, Ms, Ha^Fp, Mm, Ha^Fp, Hh^Fp, Hh^Fp, Aa, Aa, Ha^Fp, Gg^Efm, Wo, Ss, Gg^Fp, Gg^Efm, Gg, Gg^Fms, Gg, Re, Gg^Fp, Gg^Dr, Gg, Rb, Gs, Gs^Efm, Gg, Gg, Gs, Gs, Gg^Qhh, Gs^Edp, Gg
Ms, Ms, Ww, Ms, Mm, Ms, Ha, Ha^Efm, Hh, Ha^Fp, Aa, Hh, Hh^Fp, Hh^Vo, Re^Efm, Hh^Fp, Wo^Wkf, Wo, Gg^Fp, Gg^Fp, Gg^Fp, Hh, Rb^Es, Gg^Fp, Rb, Gg^Dr, Co, Gg^Dr, Co, Rb, Rb, Gg, Gs, Gg, Gg^Qhh, Gg^Edp, Gs^Qhh, Gs
Ms, Ms, Ai, Ww, Ww, Ms, Ms, Ha, Ha, Hh^Efm, Hh^Fp, Aa, Hh^Fp, Gg^Fp, Hh, Re, Wo, Ww, Rb, Rb, Rb^Efm, Rb, Gg^Fms, Rb, Gg^Eb, Co, Co, 3 Ko, Co, Co, Gg^Ebn, Rb, Rb, Gs, Gs, Gs^Qhh, Gd^Qhh, Gs^Qhh
Mm, Mm, Mm, Ms, Ww, Ha, Aa, Mm, Mm, Hh^Fp, Hh^Fp, Gg, Re, Hh, Hh^Fp, Re, Wwr^Bw/r, Rb, Ww, Gg^Fp, Wwf, Gg^Vo, Gg, Gg^Fp, Rb^Eff, Rb^Eff, Rb^Dr, Co, Rb^Emf, Rb^Eff, Rb^Eff, Gg, Rb, Gs^Qhh, Gs, Gs, Gd^Qhh, Gd^Qhh
Mm, Mm, Mm, Ms, Hh, Ww, Hh, Hh, Re, Re, Re, Re, Hh^Es, Re, Re^Fp, Rb, Gg^Fp, Wo^Efs, Wo, Wo^Ewl, Wo, Re, Re, Gg, Gg^Es, Rb^Eff, Rb^Fp, Co, Rb, Rb^Eff, Gg^Em, Gs, Rb, Rb, Rb, Gd^Qhh, Rb, Rb
Mm, Mm, Mm, Mm, Mm, Ww, Wwr, Re^Vo, Hh^Efm, Mm, Mm, Hh, Gg^Fp, Hh^Es, Gg, Rb^Efm, Gg, Gg^Fp, Re, Ww, Ww, Wo, Ss, Gg, Gg, Gg, Gg, Gg, Gg, Gs^Em, Gg, Gg, Rb, Gg, Gs, Rb, Gs, Gs^Edp
Mm, Mm, Mm, Mm, Mm, Mm, Hh^Fp, Wo, Ww, Hh, Gg^Fp, Hh^Fp, Hh^Fp, Hh, Hh^Fp, Gg, Gg^Fp, Gg^Fp, Gg, Re, Gg^Efm, Wo, Ww^Wkf, Gg, Gg, Gg^Efm, Gg, Gg, Gg, Gg^Efm, Gd^Vo, Gs, Rb, Gg, Gg, Gg^Efm, Gg, Gs^Qhh
Mm, Mm, Mm, Mm, Hh^Fp, Mm, Hh^Fp, Hh, Wo, Gg^Fp, Gg, Hh, Gg^Fp, Hh, Gg^Fp, Re^Es, Re, Gg^Efm, Gg^Fp, Gg^Fp, Gg, Wo, Wo, Ww^Wkf, Gg^Es, Gg, Gg, Gg, Gg, Gg, Gg^Em, Rb, Gg, Gg, Gg, Gg, Re, Gg
Mm, Mm, Mm, Gg^Efm, Hh^Fp, Hh^Fp, Hh, Gg, Wo, Hh^Fp, Gg^Fp, Hh, Gg, Gg^Efm, Gg^Fp, Gg^Fp, Hh, Gg, Re, Gg, Hh, Wwf, Ww, Wo, Re, Re, Ww, Re, Wwf, Gg, Rb, Rb, Ww^Ewl, Ss, Ww, Ww, Ww^Wkf, Re
Mm, Mm, Mm, Hh^Vo, Re, Gg^Fp, Gg, Hh, Gg^Efm, Wo^Wkf, Wwr, Gg, Gg^Fp, Gg, Gg, Gg, Gg^Fp, Re^Vo, Hh, Re, Hh^Fms, Gg^Efm, Ww, Wo, Wwr, Ww, Wo, Wo, Wo, Wwf, Rb, Ww^Wkf, Wo, Wo, Wo, Wo, Wo^Wkf, Ww^Wkf
Mm, Mm, Mm, Mm, Re, Hh^Fp, Gg^Fp, Gg^Fp, Gg, Hh, Wwf, Wo^Ewl, Gg^Fp, Gg, Hh, Gg^Efm, Gg^Efm, Hh, Hh^Fp, Re^Fms, Re, Re^Fp, Re, Ww^Ewl, Hh, Wo, Re, Ww^Ewf, Ww, Wo, Ww, Wwr, Wwr, Ww^Wkf, Ww, Ww, Ww^Ewl, Wo
Mm, Mm, Mm, Mm, Re, Hh, Re, Hh, Hh, Gg, Gg^Efm, Wo, Ww, Gg^Efm, Gg^Fp, Gg, Hh, Gg, Hh^Fp, Hh^Es, Mm, Hh, Re^Fp, Gg^Efm, Gg, Re, Hh, Gg, Ww^Wkf, Wo, Wo, Wo, Gg^Fp, Rb, Gg, Wwf, Wwf, Ww
Mm, Mm, Hh, Gg^Fp, Hh^Fp, Re^Es, Gg^Fp, Re, Re, Re, Wo^Wkf, Wo, Ww^Ewl, Gg, Gg, Gg, Gg, Hh, Gg^Es, Hh^Fp, Hh^Fp, Mm, Hh^Vo, Hh^Fp, Gg, Gg, Gg^Efm, Gg, Gg^Fp, Ww, Ss, Re, Rb, Rb^Efm, Gg^Fp, Gg, Gg, Wwf
Hh, Mm, Hh^Fp, Hh, Hh, Hh^Fp, Gg^Fp, Gg^Fp, Hh, Re, Wo, Ww, Re^Vo, Gg^Fp, Gg^Fp, Gg^Efm, Wwf, Gg, Hh, Gg, Gg^Fp, Mm, Re, Hh^Fp, Mm, Hh, Hh^Fp, Gg^Fms, Gg, Gg^Efm, Gg^Fp, Gg, Gg^Fp, Gg, Gg, Gg, Gs, Gg
Hh, Hh^Fp, Gg^Fp, Hh, Gg^Fp, Gg^Efm, Gg, Rb, Gg^Fp, Ss, Ww, Wo, Re, Gg^Fp, Wo, Wo^Wkf, Wo, Wwr, Wo, Gg, Hh^Fp, Hh^Fp, Re, Mm, Mm, Mm, Gg^Fp, Hh^Fp, Hh, Gg, Gg^Fms, Gg, Gg^Fms, Gg^Fp, Gg^Fp, Gg^Es, Gs, Gs
Gg^Fp, Hh, Gg, Gg^Fms, Gg^Fms, Hh, Gg, Gg, Gg^Fp, Gg, Gg^Efm, Wo, Wo^Wkf, Ww, Wo, Ww, Hh, Wwr, Wo, Gg^Efm, Gg^Fp, Re, Hh^Fp, Mm, Hh, Hh^Fp, Gg^Fp, Hh, Gg^Fms, Gg, Gg, Re^Vo, Gg^Fms, Gg, Gg, Gg, Gs, Gs^Es
Gg^Fp, Gg^Fp, Gg^Efm, Gg^Fp, Gg, Gg^Fp, Rb, Hh^Fp, Gg^Fp, Gg, Gg, Re, Gg^Efm, Wo, Hh, Ss, Gg^Fp, Ww^Ewl, Wo, Ww^Wkf, Ww, Re^Fp, Re, Hh, Hh^Fp, Gg^Fp, Re, Re^Fp, Re, Gg^Efm, Re, Re, Gg, Gg, Gs, Gg^Fms, Gs, Gd
Gg, Gg, Gg^Fp, Gg^Efm, Gg, Re^Vo, Rb, Gg, Gg^Fp, Gg, Hh, Gg, Gg, Gg^Fp, Hh^Fp, Hh, Hh^Fp, Gg^Efm, Gg, Wo^Wkf, Wo, Gg^Efm, Gg, Re^Efm, Re, Re, Hh^Fp, Hh, Gg, Re, Hh, Gg^Fp, Gg^Fp, Gg^Fp, Gg, Gs, Gd, Gd
Gg^Fp, Gg, Gg^Fp, Gg, Gg, Gg^Fp, Gg, Rb^Es, Gg^Dr, Gg, Gg, Hh, Hh, Hh, Hh, Gg^Fp, Hh, Hh^Vo, Gg, Ww, Wo, Ww, Ww^Ewf, Gg^Fp, Gg, Gg^Fp, Gg^Efm, Gg^Fp, Gg^Fp, Gg, Gg, Gg^Fp, Gg, Gg^Fms, Gg^Fms, Gs^Es, Gs, Gg
Gg^Fp, Gg, Gg, Gg^Es, Gg^Es, Gg^Fp, Gg, Chr, Chr, Gg^Efm, Gg, Hh^Fp, Mm, Mm, Hh, Hh^Fms, Hh, Gg, Gg^Fms, Wwf, Ww^Wkf, Wo, Ww, Re, Gg, Gg^Fp, Ww, Re, Ww, Ww, Ww, Gg, Gg^Efm, Gg^Fp, Gg, Gg, Gs, Gg
Gg^Fp, Gg^Fp, Gg^Fms, Gg^Fp, Gg, Gg, Gg^Fp, Chr, 2 Khr, Hh, Hh, Hh^Fp, Hh^Fp, Mm, Hh^Fp, Gg, Gg, Gg^Fp, Gg^Fp, Wwf, Ww, Wo, Wo, Gg, Re, Ww, Wo, Re, Wo^Wkf, Wo, Wo, Gg, Gg, Gg, Gs, Gg^Fds, Gs, Gg
Gg, Gg^Fp, Gg^Fms, Gg^Fp, Gg, Gg^Efm, Gg, Rp, Chr^Efs, Chr, Hh^Fp, Hh, Mm, Hh^Fms, Hh^Fms, Gg, Gg^Fms, Hh, Gg, Gg, Gg^Efm, Ww, Wo, Ss, Wwr, Wo, Ww, Wo, Wwf, Ww^Wkf, Wwr^Bw/r, Gg^Efs, Re, Gs, Gg^Efm, Gg, Gs^Es, Gg
Gg, Gg^Fp, Gg, Gg, Re, Re, Re, Re, Rp, Chr, Gg, Hh, Hh^Fp, Hh, Gg^Fms, Gg, Gg^Fp, Gg, Gg^Es, Gg, Gg, Gg^Efm, Wo, Ww^Wkf, Wwr, Wo^Wkf, Ww^Ewl, Wwf, Gg^Efm, Gg, Wo, Ww^Wkf, Ww, Re, Gg, Gg, Gg, Gg
Gg^Fp, Gg^Es, Re^Vo, Gg^Fp, Re, Gg^Fp, Gg^Efm, Gg, Hh^Fp, Rp, Hh, Hh^Es, Gg, Hh^Fp, Gg^Fp, Gg, Gg, Gg, Gg^Fp, Re^Vo, Re, Re, Gg, Wo, Gg^Efm, Ww, Re, Gg^Vo, Gg, Ss, Ww, Wo, Ww^Ewf, Gg, Wwf, Wwf, Ww^Ewl, Re
Gg, Gg, Gg, Re, Gg^Fp, Gg, Gg, Gg, Hh, Rp, Rb, Rp, Rb, Gg^Fp, Rb, Gg, Rb, Gg, Gg^Es, Gg^Efm, Re, Gg, Gg, Gg^Efm, Gg, Re, Gg, Gg, Gg, Gg, Gg^Efm, Wo, Wo, Ww, Wo, Ww, Wo, Ww
Gg, Gg^Fp, Gg, Gg^Es, Hh, Gg, Hh^Fp, Gg, Hh^Es, Hh, Gg^Fms, Gg^Efm, Gg, Rp, Gg^Fp, Rb, Gg^Fds, Rb, Rb, Rb, Rb, Gg, Gg, Gg, Gg, Gg, Gs, Gs, Gg, Chr, Chr, Chw, Chw, Wo^Wkf, Ww^Wkf, Wo, Ww, Wo
Gg^Fp, Gg, Hh, Gg, Gg, Hh, Gg^Fp, Gg, Gg^Es, Hh, Gg, Gg, Gg^Fms, Rb, Gg, Gg, Gg, Gg, Gg^Efm, Gg, Gg, Rp, Rb, Gs^Es, Rb, Gs, Rp, Gs, Gs^Es, Gg, Chr, 1 Khr, Chr, Gg, Re, Ww, Ss, Ww
Hh, Hh, Hh, Gg^Fp, Hh^Fp, Gg, Hh, Gg, Gg^Es, Gg, Gg^Efm, Re^Vo, Rb, Rb, Gg^Efm, Gg, Gg, Gg, Gg, Gg, Gg, Gg, Gg, Rb, Gs, Rb, Gd, Rb, Rp, Rp, Gs, Chr^Efs, Gg^Dr, Chr, Gg, Gg^Efm, Gg, Ss
Gg, Gg^Fp, Hh, Hh, Hh, Gg, Gg, Hh, Gg, Gg, Gg, Rb, Gg^Fp, Re^Wm, Gg, Gg, Gg, Gg^Fds, Gg, Gg, Gs, Gg^Es, Gg, Gs, Gg, Re^Vo, Gd, Gs^Qhh, Gd^Qhh, Gs^Qhh, Gg^Es, Gg, Gs, Gs^Qhh, Gs^Es, Gg, Gs, Gg
Gg, Hh, Gg, Hh^Fp, Gg, Hh, Gg, Gg, Gg, Gg, Gg, Rb, Gg, Gg, Gg, Gg, Gg, Gg, Gg, Gs, Gg, Gg, Gg, Gs, Gg, Gd, Gd^Qhh, Gd^Qhh, Gd^Qhh, Gd, Gg, Gs^Qhh, Gg, Gs, Gg, Gs, Gg, Gg
