border_size=1
usage=map

Gg          , Gg          , Aa          , Ha          , Ha          , Ms          , Ms          , Ms          , Ms          , Ms          , Ms          , Ms          , Ha          , Ha          , Aa          , Aa          , Aa          , Ha          , Ms          , Ms          , Ms          , Ms          , Ha          , Ha          , Ww          , Gg          , Gg          , Aa          , Aa          , Ha          , Ha          , Hhd         , Hhd         , Hhd         , Ha^Fpa      , Ha          , Ha          , Ha          , Ms          , Ms          , Ms          , Ms          
Gs          , Gs          , Gs          , Aa          , Aa          , Hhd         , Ha          , Ms          , Hhd         , Ms          , Hhd         , Hhd         , Aa          , Aa          , Gs          , Gd          , Aa          , Ha          , Ha^Fpa      , Ms          , Ha          , Ha^Fpa      , Ha^Fpa      , Hh          , Hh          , Ww          , Gg          , Gg          , Gs          , Aa          , Aa          , Hhd         , Aa          , Aa          , Aa          , Aa          , Aa          , Ha          , Ha^Fda      , Ha^Fpa      , Ha^Fpa      , Ms          
Gs          , Gs          , Gs          , Gd^Vo       , Gs          , Aa          , Aa          , Ha^Fpa      , Ha^Fpa      , Hhd         , Gd          , Aa          , Gd^Vo       , Gs          , Gs          , Gd          , Aa          , Ha^Fda      , Aa          , Ha          , Aa          , Aa          , Aa          , Gd          , Hhd         , Ww          , Ww          , Gg          , Gg          , Gs          , Gs          , Aa          , Gs          , Hh          , Hh          , Hh          , Hh          , Aa          , Gs          , Aa          , Aa          , Ha          
Gd          , Gd          , Gd          , Gs          , Gs          , Gs          , Aa          , Aa^Fdw      , Aa          , Aa^Fdw      , Gd          , Gs          , Gs          , Gs          , Gs          , Gd^Fdw      , Gd          , Aa          , Aa          , Aa          , Gs          , Aa          , Gs          , Gd          , Gd          , Hhd         , Wwf         , Gg          , Gg          , Gg          , Gs          , Gs          , Gs          , Hh          , Hhd         , Hh          , Hhd         , Hh          , Hh          , Gs          , Gs          , Ha          
Gd          , Aa          , Aa          , Gd          , Gs          , Aa          , Gd          , Aa          , Gd          , Gd          , Gd          , Gs          , Gs          , Gs^Fdw      , Gs          , Gs          , Gs          , Gs          , Gg          , Gs          , Gg          , Gs          , Gs          , Gs          , Gd          , Hhd         , Hh          , Wwf         , Wwf         , Gg          , Gs          , Hh          , Aa          , Gd          , Gd          , Hhd         , Hh          , Hh          , Hh          , Hh          , Gs          , Aa          
Aa          , Aa          , Gd          , Gd          , Gs          , Gs          , Gs          , Gd          , Aa          , Gs          , Gs          , Gs          , Gs          , Gs          , Gs          , Gs          , Gs          , Gg          , Gg          , Gg          , Gd^Vo       , Gs          , Aa          , Co          , 3 Ko        , Co          , Gs          , Gg          , Ww          , Gg          , Gs          , Hh          , Aa          , Gs          , Gd          , Hh          , Hhd         , Mm          , Mm          , Hh          , Gs          , Gs          
Aa          , Gd          , Gs          , Gs          , Gg          , Gg          , Gs          , Gs          , Aa^Fda      , Aa          , Aa^Fdw      , Gs          , Gs          , Gd^Vo       , Gs          , Gs          , Gs          , Gg          , Gs          , Gs          , Gs          , Gs          , Aa^Fma      , Co          , Co          , Co          , Gs          , Gg          , Gg          , Ww          , Hh          , Hh          , Ha^Fpa      , Aa          , Gs          , Hh          , Mm          , Mm          , Mm          , Gd          , Gd          , Gs          
Gs          , Gs          , Aa          , Ww          , Gg          , Gg          , Gs          , Aa^Fda      , Aa          , Aa          , Co          , Gs^Fdw      , Gs^Fdw      , Gs          , Gs^Fdw      , Gs          , Gs          , Gs          , Gs          , Gs          , Gs^Fdw      , Gs^Fdw      , Aa^Fma      , Co          , Co          , Co          , Gs          , Gs          , Gg          , Ww          , Ww          , Hhd         , Ha          , Aa          , Gs          , Hh          , Hh^Fmw      , Mm          , Hh          , Hh          , Gd          , Gg          
Gs          , Gs          , Aa          , Ww          , Gg          , Gs          , Aa^Fda      , Aa^Fda      , Aa          , Co          , 5 Ko        , Co          , Gs^Vo       , Gs          , Gs          , Gs          , Gs          , Gs          , Gs          , Gs          , Gs^Fdw      , Gd          , Gd          , Aa^Fma      , Co          , Gs^Vo       , Gs          , Gs          , Gs          , Gd          , Ww          , Hh          , Hh          , Ha^Fda      , Hhd         , Hhd         , Hh          , Hh          , Ww          , Hh          , Gd          , Gg          
Gs          , Gs          , Gs          , Wwr         , Gg          , Gs          , Aa^Fda      , Aa          , Co          , Co          , Co          , Co          , Co          , Gs          , Gs          , Gs          , Aa          , Aa          , Aa          , Gs          , Gs          , Gs^Fdw      , Gd          , Co          , Co          , Co          , Gs          , Gs          , Gd          , Gd          , Gg          , Ww          , Hh          , Hh          , Hh          , Hh          , Ww          , Ww          , Ww          , Gg^Vo       , Gs          , Gs          
Aa          , Gs          , Gs          , Gg          , Gs          , Gs          , Gs          , Gs          , Gs          , Aa^Fma      , Aa^Fma      , Aa^Fma      , Gs          , Gs          , Gd          , Gd          , Gd          , Gd          , Gd          , Gd          , Gd^Vo       , Gd          , Gs          , Gd          , Gd          , Gd          , Gd          , Gs          , Gs          , Gs          , Gg          , Ww          , Ww          , Hh          , Ww          , Hh          , Hh          , Ww          , Ww          , Ww          , Gg          , Gs          
Aa          , Gs          , Aa          , Gs          , Gs          , Gs          , Gs          , Gs          , Gs          , Gs          , Gs          , Gs          , Gd^Vo       , Gs          , Gs          , Gs          , Gs          , Gs          , Gs          , Gs          , Gs          , Gd          , Gd          , Gs          , Gs          , Gs          , Gs          , Gs          , Gs          , Gs          , Gs          , Hh          , Hh          , Ww          , Gg          , Ww          , Ww          , Ww          , Gg          , Gg          , Gs          , Gg          
Aa          , Gd          , Gs          , Gs          , Gs          , Gs          , Gs          , Gs          , Gs          , Gs          , Gs          , Gs          , Gs          , Gs          , Gs          , Gs          , Gd          , Gg          , Gd          , Gs          , Gs          , Gs          , Gs          , Gs          , Gs          , Gs          , Gs          , Gs          , Gs          , Gd^Vo       , Gs          , Gd          , Co          , Hhd         , Hhd         , Gg          , Gg          , Wwr         , Ww          , Gg          , Gg          , Gg          
Gd          , Gd          , Gs^Fdw      , Gs^Fdw      , Gs^Fdw      , Gs^Fdw      , Gs          , Gs          , Gg          , Gs          , Aa          , Gd          , Gd          , Gs          , Gs          , Gd          , Gd^Fmw      , Gd          , Gd^Fmw      , Gs          , Gs          , Gs          , Aa          , Gs          , Gs          , Gs          , Gs          , Gs          , Gs          , Gs          , Gs          , Co          , 4 Ko        , Co          , Hhd         , Gd          , Gs          , Gg          , Gs          , Ww          , Ww          , Gs          
Gs          , Gs          , Gs          , Gd^Fmw      , Gd^Fmw      , Gs          , Gs          , Gg          , Ww          , Hh          , Hh          , Aa          , Gd          , Gs          , Gs          , Gs          , Gs          , Gd^Fmw      , Gs          , Gs          , Hh          , Gs          , Aa          , Gs          , Gs          , Gd^Fmw      , Gs          , Gs          , Gs          , Gs          , Gs^Vo       , Co          , Co          , Co          , Hh          , Gd          , Gs          , Gg          , Gs          , Gs          , Ww          , Gs          
Gs          , Gs          , Gs^Fdw      , Gs          , Gs          , Gs          , Gs          , Gg          , Ha^Fda      , Hh          , Gs          , Aa^Fma      , Gs          , Gs          , Gs          , Gs          , Gs          , Gs          , Gs          , Gs          , Gs          , Hh          , Hhd         , Aa          , Gs          , Gs          , Gs          , Gs          , Gs          , Gs          , Gs          , Co          , Co          , Co          , Gd          , Gd          , Gs          , Gs          , Gd          , Gs          , Gs          , Ww          
Gs          , Gs          , Gs          , Gs          , Gs          , Gs          , Gd          , Aa          , Ha^Fda      , Gs          , Gs          , Gs          , Gd          , Gs          , Aa          , Gs          , Gd          , Gs          , Gs^Fdw      , Gs          , Gd^Fmw      , Gd          , Hh          , Aa          , Aa          , Gd          , Gd          , Gs          , Gs          , Gd^Vo       , Gs          , Gs          , Gs          , Gs          , Gs          , Gs          , Gs          , Gs          , Gd          , Aa          , Gg          , Ww          
Hh          , Gs          , Gs          , Gd          , Gs          , Gs          , Gd          , Aa^Fma      , Ha^Fpa      , Gs          , Hh          , Gd^Vo       , Hh          , Gs          , Hh          , Aa          , Aa          , Gd          , Gs^Fdw      , Gs          , Gs          , Gs          , Gs          , Hh^Fmw      , Hh^Fmw      , Aa          , Gd          , Gs          , Gs          , Gs          , Gs          , Gs          , Gs          , Gs          , Gs          , Gs          , Gs          , Gs          , Gs          , Aa          , Gg          , Ww          
Mm          , Hh          , Hh          , Gd          , Gs          , Gs          , Gd          , Aa^Fma      , Aa^Fma      , Ha^Fpa      , Aa          , Hhd         , Aa          , Hh          , Gs          , Hh          , Aa          , Gd^Fdw      , Gs          , Gs          , Gs          , Gs          , Gs          , Gs          , Hh          , Aa          , Gd          , Gs          , Gs          , Gs          , Aa          , Gs          , Gs          , Gs          , Gd          , Gd          , Gd          , Gd          , Gs          , Gs          , Gs          , Gg          
Hhd         , Mm          , Hhd         , Gd          , Gs          , Gs          , Gd          , Aa          , Gd          , Aa          , Gd          , Aa          , Gs          , Gs          , Gd          , Aa          , Gd          , Gd          , Gs          , Gs          , Gs          , Gs          , Gs          , Gs          , Gs          , Gd          , Gs          , Gs          , Gs          , Gs          , Aa          , Aa^Fda      , Aa^Fda      , Gd          , Gd          , Gd^Vo       , Gd          , Gs          , Gs          , Gs          , Aa          , Aa          
Hhd         , Mm          , Mm          , Gd          , Gs          , Gs          , Gs          , Gd          , Gd^Vo       , Gd          , Gs^Fdw      , Gs          , Gs          , Gs          , Gs          , Gd          , Gs          , Gd          , Gs          , Gs          , Gs          , Gs          , Gs          , Gs          , Gs          , Gs          , Gs          , Gs          , Gs          , Gs          , Gs          , Aa          , Aa^Fda      , Gd          , Hhd         , Gd          , Gd          , Gs          , Gd          , Aa          , Hh          , Hh          
Mm          , Mm          , Hhd         , Gd          , Gd          , Gs          , Gs          , Gs          , Gs          , Gd          , Gs^Fdw      , Gs          , Gs          , Gs          , Gs          , Gs          , Gs          , Gs          , Hh          , Hh          , Mm          , Gg          , Gg          , Gs          , Gs          , Gs          , Gs          , Gs          , Gs          , Gs          , Aa          , Aa          , Aa^Fda      , Gd          , Hhd         , Gd          , Gd          , Gs          , Gd          , Aa          , Hhd         , Mm          
Hh          , Mm          , Mm          , Hhd         , Gd          , Gd          , Gs          , Gs          , Gs          , Gs          , Gs          , Gs          , Gs          , Gs          , Gs          , Gs          , Gs          , Gs          , Hh          , Mm          , Mm          , Hh          , Hh          , Gg          , Gg          , Gs          , Gs          , Gs          , Gs          , Aa          , Gd          , Aa^Fda      , Gd          , Hhd         , Gd^Vo       , Gd          , Gd          , Gs          , Gs          , Hhd         , Mm          , Mm          
Gs          , Hh          , Hh          , Mm          , Gs          , Gs          , Gs          , Gs          , Gs          , Gs          , Gd          , Gd          , Gd          , Gd          , Gs^Fdw      , Gs          , Gs          , Gs          , Gs          , Gd          , Gd          , Mm          , Hh^Fmw      , Hh          , Gg          , Gs          , Gs          , Gs          , Gd^Vo       , Gs          , Gd          , Gd          , Hhd         , Hhd         , Gd          , Gd          , Gs          , Gs          , Gs          , Hhd         , Mm          , Mm          
Gs          , Gs          , Gs          , Hh          , Gs          , Gs          , Aa          , Gs          , Gs          , Gs          , Gs          , Gs          , Gs          , Aa          , Gd^Fdw      , Gd          , Gd          , Gs          , Gs          , Gs          , Gd          , Hh          , Gg          , Gg          , Gs          , Gs          , Gs          , Gs          , Gs          , Gs          , Aa          , Gd          , Hhd         , Gd          , Gd          , Gd          , Gs          , Gs          , Hh          , Mm          , Mm          , Mm          
Gs          , Gs          , Gs          , Gs          , Gd          , Gs          , Gs          , Aa          , Aa          , Gs          , Gd          , Gd          , Aa          , Aa^Fdw      , Aa          , Aa          , Aa          , Gs          , Gs          , Gs          , Gs          , Hh          , Gs          , Gs          , Gs          , Gs          , Gs          , Gs          , Gs          , Aa          , Hh          , Hh          , Gs          , Gd          , Gd          , Gs          , Gs          , Gs          , Aa          , Hh          , Hh          , Mm          
Gs          , Gs          , Gs          , Gs          , Gd          , Gs          , Aa          , Gd          , Gd          , Gs          , Hh          , Aa          , Hh          , Hh          , Mm          , Ha^Fpa      , Ha^Fpa      , Aa          , Aa^Fma      , Gs          , Gs          , Gs          , Gs          , Gs          , Gs          , Gs          , Gd          , Aa          , Aa          , Hh          , Gs          , Gs          , Gs          , Gs          , Gd          , Gs          , Gs          , Gs          , Gs          , Aa          , Gs^Fdw      , Hh          
Gs^Fmw      , Gs          , Gs          , Gs          , Gd          , Gs          , Gs          , Gd          , Aa          , Aa          , Hh^Fdw      , Aa          , Mm          , Hh^Fdw      , Mm          , Mm          , Mm          , Ha^Fda      , Aa^Fma      , Gd          , Gd          , Gs          , Gs          , Gs          , Gs          , Gd          , Gd          , Hh          , Hh          , Gd          , Gs          , Gs          , Gs          , Gs          , Gs          , Gs          , Gs          , Gs          , Gs          , Gs          , Gg          , Gs          
Gs          , Gs^Fmw      , Gs          , Gs          , Gd^Vo       , Gs          , Gs          , Gs          , Gs          , Hh          , Mm          , Mm          , Mm          , Mm          , Hhd^Fdw     , Mm          , Hh          , Ha^Fda      , Aa^Fma      , Aa          , Gd          , Gs          , Gd          , Gs          , Gs          , Gs^Fdw      , Gs^Fdw      , Gd          , Gd          , Gd          , Gs          , Gs          , Gs          , Aa          , Gs          , Gs          , Gs          , Gs          , Gs          , Gg          , Gs          , Gg          
Gs          , Gs          , Gs          , Gs          , Gs          , Gd          , Gs          , Gs          , Hh          , Hh          , Hh^Fdw      , Hh^Fdw      , Mm          , Hhd         , Gd^Vo       , Hhd         , Hh          , Aa          , Gd          , Gd          , Gs          , Gd^Vo       , Gs          , Gs          , Gs          , Gs^Fdw      , Gs          , Gs          , Gs          , Gs          , Gs          , Hh          , Ha^Fda      , Aa          , Gs          , Gs          , Gs          , Gs^Fdw      , Gs          , Gs          , Aa          , Gs          
Gs          , Gs          , Gs          , Gs          , Gs          , Gs          , Gs          , Gs          , Gs          , Hh          , Hh          , Mm          , Mm          , Mm          , Hh          , Hh          , Gs          , Gd          , Gs          , Gs          , Gs          , Gs          , Gs          , Gs          , Gs          , Gs          , Gs          , Gs          , Hh          , Hh          , Mm          , Hh          , Ha^Fda      , Aa^Fma      , Aa^Fma      , Gs          , Gs          , Gs          , Gs          , Aa          , Aa          , Gg          
Hh          , Gs          , Gs          , Gs          , Gs          , Gs          , Gs          , Gs          , Gs          , Hh          , Gs          , Mm          , Hh          , Hh^Fdw      , Gs          , Gs          , Gs          , Gs          , Gs          , Gs          , Gs          , Gs          , Gs^Fdw      , Gs^Fdw      , Gs          , Gs          , Gs          , Hh          , Gs          , Hh^Fmw      , Hh          , Hhd         , Hh          , Ha^Fpa      , Aa          , Gs          , Gs          , Gs          , Aa          , Gd          , Gd          , Gs          
Hh          , Hh^Fmw      , Hh          , Hh          , Hh          , Hh          , Hh^Fmw      , Gs          , Gs          , Gs          , Gs          , Gs          , Gs          , Gs          , Gs^Fdw      , Gs          , Gs          , Gs          , Gs          , Gs          , Gs          , Gs          , Gd          , Gs^Fdw      , Gs^Fdw      , Gs          , Gs          , Gs          , Gs          , Gs          , Gs          , Gd          , Hh          , Mm          , Mm          , Aa          , Aa          , Gs          , Gd          , Gs          , Hh^Fdw      , Gd          
Mm          , Mm          , Mm          , Mm          , Mm          , Hh          , Aa          , Gs          , Gs          , Gs          , Gs          , Gs          , Gs          , Gs^Fdw      , Gs          , Gs          , Gs          , Gs          , Gs          , Gs          , Gs          , Gs          , Gs          , Gd          , Gd          , Gs          , Gs          , Gs          , Gs          , Gs          , Gd          , Gd^Vo       , Gd          , Hhd         , Hhd         , Hh          , Aa          , Gs          , Gd^Vo       , Gs          , Hh          , Gs          
Ha^Fpa      , Ha^Fpa      , Ha          , Hhd         , Ha          , Ha          , Aa          , Gs          , Gs          , Gs          , Gs          , Gs          , Gs          , Gs          , Gs          , Gs          , Gs          , Gs          , Gs          , Gs          , Gs          , Gs          , Gs^Fdw      , Gs          , Gd^Vo       , Gd          , Gs          , Gs          , Gs          , Gs          , Gd          , Gd          , Aa          , Ha          , Ha          , Mm          , Mm          , Aa          , Aa          , Hhd         , Aa          , Gs          
Ha          , Ha          , Hhd         , Ha          , Ha          , Ha          , Aa          , Gs          , Gs          , Gs          , Gd          , Gs          , Gs          , Gs          , Gs          , Gs          , Gs          , Gs          , Chr         , Chr         , Aa          , Gs          , Gs          , Gs          , Aa          , Gd          , Gs          , Gs          , Gs          , Gs          , Gs          , Gs          , Gs          , Aa          , Aa          , Ha          , Mm          , Aa          , Ha          , Ha          , Aa          , Gs          
Ms          , Ms          , Ms          , Ms          , Ms          , Ha          , Ha^Fpa      , Aa          , Aa          , Gd          , Gd          , Gd^Vo       , Gd          , Gs          , Aa          , Gs          , Gs          , Gs          , Chr         , 1 Khr       , Chr         , Aa          , Gs          , Aa          , Ms          , Aa          , Aa          , Gs          , Gs          , Gs          , Gs          , Gs          , Aa          , Gs          , Aa          , Ha          , Ha          , Ha          , Ha          , Ha          , Aa          , Aa          
Ms          , Ms          , Ms          , Ms          , Ms          , Ms          , Ha          , Ha^Fpa      , Ha^Fpa      , Gd          , Ha          , Gd          , Gd          , Aa          , Ha^Fpa      , Aa          , Ha          , Gs^Vo       , Chr         , Chr         , Ms          , Aa          , Aa          , Ms          , Ha          , Ha          , Aa^Fma      , Aa^Fma      , Aa          , Gs          , Aa          , Gs          , Gs          , Aa          , Ha          , Ha          , Ha          , Ha          , Ha          , Ha          , Ha          , Aa          
Ms          , Ms          , Ms          , Ms          , Ms          , Ms          , Ms          , Ms          , Ms          , Hhd         , Hhd         , Hhd         , Ha^Fpa      , Ha^Fpa      , Ms          , Ha^Fpa      , Ms          , Ha          , Chr         , Chr         , Chr         , Ms          , Ms          , Ms          , Ha^Vhha     , Ms          , Ha          , Ha^Fpa      , Ha^Fpa      , Aa          , Ha^Fpa      , Aa          , Ha          , Ha          , Ha          , Ha          , Ms          , Hhd         , Hhd         , Ha          , Ha          , Ha          
Ms          , Ms          , Ms          , Ms          , Ms          , Ms          , Ms          , Ms          , Ms          , Ms          , Ms          , Hhd         , Ms          , Ms          , Ms          , Ms          , Ms          , Ha          , Chr         , 2 Khr       , Chr         , Ms          , Ms          , Ms          , Ms          , Ms          , Ms          , Ms          , Ms          , Ha^Fpa      , Ms          , Aa          , Ha          , Ha          , Ms          , Ms          , Ms          , Ms          , Ms          , Ms          , Ms          , Ms          
Ms          , Ms          , Ms          , Ms          , Ms          , Ms          , Ms          , Ms          , Ms          , Ms          , Ms          , Ms          , Ms          , Ms          , Ms          , Ms          , Ms          , Ms          , Ms          , Chr         , Ms          , Ms          , Ms          , Ms          , Ms          , Ms          , Ms          , Ms          , Ms          , Ms          , Ms          , Ms          , Ms          , Ms          , Ms          , Ms          , Ms          , Ms          , Ms          , Ms          , Ms          , Ms          
