Aa, Aa, Aa, Ha, Ha^Fma, Ms, Ms, Ms, Ms, Ms, Ms, Ms, Ha, Ha, Aa, Aa, Aa, Ha, Ms, Ms, Ms, Ms, Ha, Ha, Ai, Gd, Gd, Aa, Aa, Ha, Ha, Ha, Ha, Ha, Ha^Fpa, Ha, Ha, Ha, Ms, Ms, Ms, Ms
Aa, Aa, Gd^Gvs, Aa, Aa, Ha^Fma, Ha, Ms, Ha^Fma, Ms, Ha^Fma, Ha, Aa, Aa, Aa, Gll^Efm, Aa, Ha, Ha^Fpa, Ms, Ha, Ha^Fpa, Ha^Fpa, Ha^Fma, Ha, Ai, Gd^Efm, Aa, Aa, Aa, Aa, Ha, Aa, Aa, Aa, Aa, Aa, Ha, Ha^Fda, Ha^Fpa, Ha^Fpa, Ms
Rb, Gll, Rb, Rb^Vo, Gll, Aa, Aa, Ha^Fpa, Ha^Fpa, Ha, Aa, Aa, Rb^Vo, Gd, Gd^Efm, Gd, Aa, Ha^Fda, Aa, Ha, Aa, Aa, Aa, Aa, Ha, Ai, Ww, Gd^Fmw, Gd^Efm, Gd^Fmw, Aa, Aa, Aa, Ha, Ha, Ha, Ha, Aa, Aa, Aa, Aa, Ha
Gd, Rb, Gd^Efm, Rb, Rb, Gd, Aa, Aa^Fdw, Aa, Aa^Fdw, Aa, Gd, Rb, Gd, Gll, Aa^Fdw, Gd, Aa, Aa, Aa, Gd^Fmw, Aa, Gll^Qhu, Gd, Aa, Ha, Wwf, Gd, Aa, Gd^Fmw, Gd, Gd, Aa, Ha, Ha, Ha, Ha^Fma, Ha, Ha, Aa, Aa, Ha
Gd, Aa, Aa, Gd, Rb, Aa, Gll, Aa, Rb, Gd, Gd, Aa, Rb, Gll^Fmw, Gd, Gd, Aa, Gd, Gll, Gll^Fmw, Re^Gvs, Aa, Gd^Qhu, Gll^Qhu, Aa, Ha, Ha, Wwf, Wwf, Gd, Aa, Ha, Aa, Aa, Aa, Ha, Ha^Fma, Ha^Fma, Ha, Ha, Aa, Aa
Aa, Aa, Gd^Qhu, Gd^Fmw, Gd, Rb, Rb, Rb, Aa, Rb, Rb, Rb, Gd, Re^Gvs, Re^Gvs, Aa, Gll^Qhu, Aa, Gd, Re^Gvs, Rb^Vo, Re^Gvs, Rb, Co, 3 Ko, Co, Aa, Aa, Wwr, Gd, Gd^Fmw, Ha, Aa, Aa, Aa, Ha, Ha^Fma, Ms, Ms, Ha, Aa, Gd
Aa, Gd^Qhu, Gll, Gd, Aa, Gd, Gd^Efm, Gd, Aa^Fda, Aa, Aa^Fdw, Rb, Rb, Rb^Vo, Gd, Gd^Qhu, Aa^Qhu, Gll^Qhu, Rb, Rb, Gd, Rb, Aa^Fma, Co, Co, Co, Gd^Ecf, Aa, Gd^Wm, Ww, Ha, Ha, Ha^Fpa, Aa, Aa, Ha^Fma, Ms, Ms, Ms, Aa, Aa, Gd
Gd, Gll, Aa, Ww, Gd, Aa, Gll, Aa^Fda, Aa, Aa, Co, Gll^Fmw, Gll^Fmw, Rb, Gll^Fmw, Gd^Efm, Gd, Gd^Qhu, Rb, Gd, Gll^Fmw, Gll^Fmw, Aa^Fma, Co, Co, Co, Gd, Gd^Efm, Gd, Ww, Ai, Ha, Ha^Fma, Aa, Aa, Ha^Fma, Ha^Fmw, Ms, Ha, Ha, Aa, Aa
Gd, Gd^Efm, Aa, Ww, Gd^Efm, Gll, Aa^Fda, Aa^Fda, Aa, Co, 5 Ko, Co, Gd^Vo, Rb, Rb, Rb, Rb, Rb, Rb, Aa, Aa^Fdw, Gd, Gd, Aa^Fma, Co, Gd^Vo, Rb, Aa, Gll^Fmw, Gd, Ai, Ha, Ha^Fma, Ha^Fda, Ha, Ha, Ha, Ha, Ai, Ha, Rb, Aa
Gd, Gd^Fmw, Gd^Fmw, Wwr, Gd^Efm, Gd, Aa^Fda, Aa, Co, Co, Co, Co, Co, Rb, Gd, Gd, Aa, Aa, Aa, Rb, Aa, Gll^Fmw, Gd, Co, Co, Co, Aa, Rb, Rb, Gll^Fmw, Gd, Ai, Ha, Ha, Ha^Fma, Ha, Ai, Ai, Ww, Rb^Vo, Gd^Gvs, Rb
Aa, Gd, Gd^Fmw, Gd, Gd^Qhu, Gd^Fmw, Gll^Qhu, Gd, Gd, Aa^Fma, Aa^Fma, Aa^Fma, Rb, Gd^Ecf, Gll, Gd, Re, Gd, Gd^Efm, Rb, Rb^Vo, Gd^Gvs, Rb, Rb, Gd, Aa, Gd, Gd, Rb, Gd^Efm, Aa, Ai, Ai, Ha, Ai, Ha, Ha, Ww, Ww, Ww, Aa, Gd
Aa, Gd, Aa, Gll, Gll^Qhu, Gd^Qhu, Gd^Efm, Gd, Gd^Efm, Aa, Gd, Rb, Rb^Vo, Gd, Gll, Re, Aa, Gll, Gll^Efm, Gd, Rb, Rb, Gll^Qhu, Gd^Efm, Gd, Aa, Gd^Efm, Aa, Rb, Re^Gvs, Aa, Ha, Gd, Ai, Aa, Ai, Ww, Ww, Gd, Gll, Aa, Aa
Aa, Aa, Gd^Efm, Gd^Qhu, Gd, Gd^Qhu, Gd, Aa, Rb, Rb, Rb, Rb, Re^Gvs, Re^Gvs, Re^Gvs, Gd, Aa, Gll, Aa, Gd, Aa, Gd, Gd^Qhu, Aa, Gd^Fmw, Gll, Re, Gd, Rb, Rb^Vo, Gd, Gd, Co, Ha, Gd, Aa, Gll^Fmw, Wwr, Wwr, Gd, Gd^Efm, Gll
Aa, Aa, Aa^Fdw, Aa^Fdw, Gll^Fmw, Gll^Fmw, Gll, Rb, Aa, Aa, Aa, Rb, Rb, Re^Gvs, Gd, Gd, Gd^Fmw, Gd, Gd^Fmw, Gd, Aa, Gd^Qhu, Aa^Qhu, Gll^Qhu, Gd^Efm, Gll, Gd, Rb, Aa, Gd, Gd^Ecf, Co, 4 Ko, Co, Ha, Gd, Gd, Gd, Aa, Ai, Ww, Gd
Gd, Gd, Gd, Gd^Fmw, Gd^Fmw, Gd, Rb, Rb, Ww, Ha, Ha, Aa, Rb, Aa, Gd, Gll^Qhu, Gd^Qhu, Gd^Fmw, Gd, Aa, Ha, Gd, Aa, Gd^Qhu, Gd, Aa^Fmw, Aa, Rb, Gd, Aa, Rb^Vo, Co, Co, Co, Ha, Aa, Gll^Qhu, Gll^Qhu, Aa, Gd, Ww, Gd
Gd, Aa, Aa^Fdw, Gd, Rb, Rb, Aa, Aa, Ha^Fda, Ha^Fpa, Aa, Aa^Fma, Rb, Gd, Aa, Gll^Qhu, Gd^Qhu, Aa, Gd, Aa, Aa, Ha, Ha^Fda, Aa, Re, Aa, Aa, Rb, Rb, Gd, Rb, Co, Co, Co, Aa, Aa, Gd^Qhu, Gll^Qhu, Gd^Qhu, Gd, Gll^Fmw, Ai
Aa, Gll, Gll, Gd, Rb, Aa, Gd, Aa, Ha^Fda, Aa, Aa, Rb, Aa, Gd, Aa, Gd, Aa, Gd, Gll^Fmw, Gd, Gd^Fmw, Aa, Ha^Fma, Aa, Aa, Re, Gd, Gd^Efm, Gd^Gvs, Rb^Vo, Gd^Efm, Gll, Gll, Rb, Rb, Gd^Efm, Gd^Efm, Gll^Fmw, Gll^Fmw, Aa, Gd, Ww
Ha, Aa, Aa, Aa, Gd, Rb, Aa, Aa^Fma, Ha^Fpa, Aa, Ha, Rb^Vo, Ha^Fpa, Aa, Ha^Fma, Aa, Aa, Gd, Aa^Fdw, Gd, Gll, Gd^Fma, Aa, Ha^Fmw, Ha^Fmw, Aa, Gd, Aa, Rb, Rb, Gd, Gll, Gd, Gd, Rb, Aa, Gd, Aa, Gll^Fmw, Aa, Gd, Ww
Ms, Ha, Ha, Aa, Gd^Efm, Rb, Aa, Aa^Fma, Aa^Fma, Ha^Fma, Aa, Ha, Aa, Ha, Aa, Ha, Aa, Gd^Fdw, Gd, Gd, Aa, Gd, Gd, Aa, Ha, Aa, Gd^Fmw, Gd, Rb, Gd, Aa, Gd, Gll^Fmw, Aa, Rb, Re^Gvs, Re^Gvs, Re, Aa, Gd, Gll, Gd
Ha, Ms, Ha^Fpa, Gll^Fmw, Aa, Rb, Rb, Aa, Gd, Aa, Gd, Aa, Gd, Re, Aa, Aa, Aa, Aa, Gll, Gd, Gd, Aa, Gll, Aa, Aa, Gd^Fmw, Aa, Gd^Qhu, Gd^Qhu, Rb, Aa, Aa^Fda, Aa^Fda, Aa, Rb, Rb^Vo, Re^Gvs, Gll^Fmw, Gd, Aa, Aa, Aa
Ha, Ms, Ms, Aa, Aa, Gd, Aa, Rb, Rb^Vo, Aa, Aa^Fdw, Gll, Gll, Aa, Gll^Fmw, Gd, Aa, Gd, Aa, Aa, Aa, Gll, Gd, Gd, Aa, Gd, Gll^Qhu, Gll^Qhu, Gd^Qhu, Rb, Gd, Aa, Aa^Fda, Aa, Ha, Rb, Rb, Aa, Gll, Aa, Ha, Ha
Ms, Ms, Ha^Fpa, Aa, Gll^Fmw, Gd, Gll, Rb, Rb, Re^Gvs, Gll^Fmw, Gd^Qhu, Gd^Qhu, Aa, Gd^Wm, Aa, Gd, Gd^Efm, Ha, Ha, Ms, Aa, Gg, Gd, Gd, Gd, Aa, Aa, Rb, Rb, Aa, Aa, Aa^Fda, Aa, Ha, Aa, Rb, Aa, Aa, Aa, Ha^Fpa, Ms
Ha, Ms, Ms, Ha, Aa, Aa, Aa, Gd^Efm, Rb, Re^Gvs, Gd, Re, Gll^Qhu, Gd, Gd, Gll, Gd^Efm, Aa, Ha, Ms, Ms, Ha, Ha, Aa, Aa, Gd^Fmw, Gd, Aa, Rb, Aa, Gd, Aa^Fda, Aa, Ha, Rb^Vo, Aa, Rb, Gd^Efm, Aa, Ha, Ms, Ms
Aa^Fpa, Ha^Fpa, Ha, Ms, Aa, Gd, Rb, Rb, Gll, Gll, Gd, Gd^Qhu, Gd^Qhu, Gd^Qhu, Gll^Fmw, Gd, Aa, Gd, Aa, Aa, Aa, Ms, Ha^Fmw, Ha, Aa, Gd^Fmw, Gd, Rb, Rb^Vo, Gd, Gd^Fmw, Aa, Ha, Ha, Gd, Rb, Gd^Gvs, Gd^Gvs, Aa, Ha^Fpa, Ms, Ms
Gs, Aa, Gs, Ha, Gd, Rb, Aa, Gd, Gd^Efm, Aa, Gd, Aa, Gd, Aa, Gd^Fdw, Gd^Efm, Gd, Gll, Gd, Gd^Fmw, Aa, Ha, Aa, Aa, Gd^Fmw, Aa, Rb, Rb, Gd, Gd, Aa, Aa, Ha, Aa, Aa, Rb, Gll, Aa, Ha, Ms, Ms, Ms
Aa, Aa, Aa, Aa, Gd, Rb, Gd^Efm, Aa, Aa, Gd, Gll^Fmw, Aa, Aa, Aa^Fdw, Aa, Aa, Aa, Gll, Aa, Re, Gd^Efm, Ha, Aa, Gd, Rb, Gd, Rb, Gd, Gd, Aa, Ha, Ha, Aa, Gll^Fmw, Gd, Rb, Aa, Aa, Aa, Ha^Fpa, Ha^Fpa, Ms
Gd, Aa, Aa, Gd, Aa, Rb, Aa, Gll^Efm, Gd, Gll^Fmw, Ha, Aa, Ha, Ha, Ms, Ha^Fpa, Ha^Fpa, Aa, Aa^Fma, Aa, Gd^Efm, Aa, Gd, Rb, Aa, Rb, Aa, Aa, Aa, Ha, Gll, Aa, Gd, Gll^Fmw, Gll^Efm, Rb, Rb, Gd, Aa, Aa, Aa^Fdw, Ha
Aa^Fmw, Gd, Gll^Efm, Gd, Aa, Rb, Aa, Gll, Aa, Aa, Ha^Fdw, Aa, Ms, Ha^Fdw, Ms, Ms, Ms, Ha^Fda, Aa^Fma, Gd, Gll, Gd, Aa, Rb, Aa, Gd, Aa, Ha, Ha, Gd, Aa, Gd, Gll^Efm, Gd, Gd, Gd, Rb, Aa, Gd^Efm, Gll^Fmw, Gd, Aa
Aa, Aa^Fmw, Gll, Gd^Efm, Rb^Vo, Rb, Gd^Qhu, Aa, Aa, Ha, Ms, Ms, Ms, Ms, Ha^Fdw, Ms, Ha^Fpa, Ha^Fda, Aa^Fma, Aa, Re^Gvs, Gll, Rb, Rb, Gd, Gll^Fmw, Gll^Fmw, Aa, Gll, Gd, Aa, Aa, Gd, Aa, Gd^Qhu, Aa, Gd^Qhu, Rb, Rb, Aa, Rb, Aa
Ww, Ww, Wwr, Gd, Rb, Rb, Gd^Qhu, Gll^Qhu, Ha, Ha, Ha^Fdw, Ha^Fdw, Ms, Ha^Fpa, Gd^Vo, Ha, Ha, Aa, Aa, Re^Gvs, Re^Gvs, Rb^Vo, Rb, Gd^Efm, Gll^Qhu, Aa^Fdw, Gd, Gd, Aa, Aa, Aa, Ha, Ha^Fda, Aa, Gd^Qhu, Gd^Qhu, Aa, Gll^Fmw, Rb, Rb, Aa, Rb
Gd, Gd, Ww, Aa, Gd, Rb, Rb, Aa, Aa, Ha, Ha, Ms, Ms, Ms, Rb, Ha, Aa, Gd^Fmw, Gd^Fmw, Aa, Gll, Rb, Gd, Gd^Qhu, Aa^Qhu, Gll^Qhu, Aa, Aa, Ha, Ha, Ms, Ha, Ha^Fda, Aa^Fma, Aa^Fma, Gll^Qhu, Gd, Gd^Efm, Rb, Aa, Aa, Aa
Ha, Aa, Aa, Wo, Ww, Aa, Gd, Rb, Rb, Ha, Aa, Ms, Ha, Ha^Fdw, Rb, Aa, Gd^Efm, Gd^Fmw, Aa, Gll^Qhu, Aa, Rb, Gll^Fmw, Gll^Fmw, Gd, Gd^Qhu, Aa, Ha, Aa, Ha^Fmw, Ha, Ha, Ha, Ha^Fpa, Aa, Gll, Aa, Rb, Aa, Gll, Aa, Aa
Ha, Ha^Fmw, Ha, Ha, Ha, Ww, Ha^Fmw, Aa, Gd^Efm, Rb, Rb, Aa, Gd, Aa, Aa^Fdw, Rb, Gll, Gd, Re^Qhu, Gd^Qhu, Gd^Qhu, Rb, Rb, Gll^Fmw, Gll^Fmw, Gd^Qhu, Rb, Aa, Rb, Aa, Rb, Aa, Ha, Ms, Ms, Aa, Rb, Rb, Rb, Aa, Ha^Fdw, Aa
Ms, Ms, Ms, Mm, Ms, Ww, Wo, Ha, Gll, Aa, Aa, Rb, Rb, Gll^Fmw, Rb, Rb, Gll^Efm, Aa, Re, Gll^Qhu, Gd^Qhu, Re, Gd, Rb, Rb, Rb, Aa, Rb, Aa, Rb, Rb, Rb^Vo, Rb, Rb, Rb, Rb, Aa, Rb, Rb^Vo, Aa, Ha, Gs
Ha^Fpa, Ha^Fpa, Ha, Ha^Fpa, Ha^Fpa, Ha, Ww, Ha, Aa, Aa, Aa, Aa, Gd, Rb, Aa, Aa, Gd, Gd, Aa, Gll, Gll, Aa, Gll^Fmw, Rb, Rb^Vo, Gd, Aa, Ha, Aa, Gd, Ha, Aa, Aa, Ha, Ha, Ms, Ms, Aa, Aa, Ha, Aa, Gs
Ha, Ha, Ha, Ha^Fpa, Ha^Fpa, Ha^Fpa, Wo, Ha, Ha, Ha, Aa, Gll, Aa, Rb, Rb, Rb, Rb, Gd^Ebn, Chr, Chr, Aa, Gd^Ebn, Rb, Rb, Aa, Gd^Efm, Gd^Efm, Ha, Ha, Aa, Ha, Ha, Gd, Aa, Aa, Ha, Ms, Aa, Ha, Ha, Aa, Gs
Ms, Ms, Ms, Ms, Ms, Ww, Ha^Fpa, Ha^Fpa, Aa, Ha, Ha, Rb^Vo, Rb, Rb, Aa, Ha, Ha, Rb, Chr, 1 Khr, Chr, Rb, Gd, Aa, Ms, Aa, Aa, Ha, Ha, Gd, Gll, Ha, Aa, Ha, Ha, Ha, Ha, Ha, Ha^Fpa, Ha, Aa, Aa
Ms, Ms, Ms, Ms, Ww, Ww, Ha, Ha^Fpa, Ha^Fpa, Ha, Ha, Ha, Aa, Aa, Ha^Fpa, Aa, Ha, Gs^Vo, Chr, Chr, Ms, Aa, Aa, Ms, Ha, Ha, Aa^Fma, Aa^Fma, Ha, Aa, Aa, Ha, Ha, Aa, Ha, Ha^Fpa, Ha^Fpa, Ha^Fpa, Ha^Fpa, Ha, Ha, Aa
Ms, Ms, Ai, Ai, Wo, Ms, Ms, Ms, Ms, Ha, Ha^Fpa, Ha, Ha^Fpa, Ha^Fpa, Ms, Ha^Fpa, Ms, Ha, Chr, Chr, Chr, Ms, Ms, Ms, Ha^Vhha, Ms, Ha, Ha^Fpa, Ha^Fpa, Aa, Ha^Fpa, Aa, Ha, Ha, Ha^Fpa, Ha, Ms, Ha^Fpa, Ha^Fpa, Ha, Ha^Fpa, Ha
Ms, Ms, Ww, Wo, Ai, Ms, Ms, Ms, Ms, Ms, Ms, Ha, Ms, Ms, Ms, Ms, Ms, Ha, Chr, 2 Khr, Chr, Ms, Ms, Ms, Ms, Ms, Ms, Ms, Ms, Ha^Fpa, Ms, Aa, Ha, Ha^Fpa, Ms, Ms, Ms, Ms, Ms, Ms, Ms, Ms
Ms, Ww, Ms, Ms, Ms, Ms, Ms, Ms, Ms, Ms, Ms, Ms, Ms, Ms, Ms, Ms, Ms, Ms, Ms, Chr, Ms, Ms, Ms, Ms, Ms, Ms, Ms, Ms, Ms, Ms, Ms, Ms, Ms, Ms, Ms, Ms, Ms, Ms, Ms, Ms, Ms, Ms
