Ds, Gs, Gs, Gg, Gg^Fdw, Rr^Fdw, Rr, Gs, Gs^Fdw, Gs, Gs, Ds, Gs^Fdw, Ds, Ds, Gs, Gs^Qhh, Gs, Gs, Gs, Gs, Gs^Fdw, Gs, Gs, Gs^Fdw, Gs^Fdw, Ww, Gs, Gs, Gs, Gd^Fdw, Gg, Gg, Gg, Gs, Gg, Gg^Fdw, Gg, Gg, Gg, Gs, Gs, Re, Ww, Ww, Ww, Ww, Gs, Gg, Gd^Fdf
Wwr, Ds, Ds, Gg, Gg^Efm, Gg^Fdw, Rr^Vhc, Rr, Rrc, Ket, Ket, Gs, Rr, Gs, Gs^Efm, Gs^Qhh, Gs^Fdw, Gs^Fts, Gs, Ds, Gs, Gs, Gs^Efm, Gs, Gs, Ds, Ww, Ww^Ewl, Ds, Gd, Ds, Gd^Es, Gs^Fdw, Hh, Ds, Ds, Ds, Gg^Es, Ch, Ch, Ch, Ch, Ch, Rr, Ch, Ww, Wo, Ww, Ds, Gd^Fdf
Ww, Wwr, Wwr, Ds, Gs, Gg, Gs, Gs, Ch, Isr, Rrc, Rrc, Rb^Eff, Rr, Rr^Vhc, Rr, Re, Gs, Gs^Efm, Ds, Gs^Fdw, Ds, Rb^Gvs, Hh, Gs, Ds, Wo, Wo, Re, Re, Re, Gs^Fdw, Gs^Fdw, Gs, Gs^Fdw, Gs^Fdw, Gs^Fdw, Ch, Rrc, Isr, Rr^Vhc, Isr, Isr, Ch, Isr, Ch, Wo, Ww, Ww, Aa^Fpa
Wo, Ww, Ww^Wkf, Ww^Wkf, Ww, Gs, Isr, Ch, 4 Kh, Rr^Vhc, Rb^Eff, Rb^Eff, Rb^Gvs, Rb^Eff, Rb^Eff, Rb^Eff, Rb^Eff, Rr, Gs, Gd^Efm, Gd, Gs^Fts, Re^Vh, Rb^Gvs, Gs^Fts, Ss, Ww^Ewf, Ww, Gs, Re^Vl, Re, Hh, Re, Gd^Fdf, Hh, Gs, Gs^Ebn, Kh, Isr^Pr\o, Rrc, Rrc, Isr, Rrc, 2 Kh, Ch, Isr, Ww, Ww, Ww, Gs
Wo, Wo^Wkf, Ww, Ww, Ww, Ww^Bw/r, Isr, Ch, Ch, Ch, Gs^Es, Rb^Eff, Rb, Rb^Eff, Gg, Rb^Eff, Rb^Eff, Re^Eff, Rr, Gs, Ds, Gs^Fdw, Re, Gs^Fdw, Gll^Feth, Gs^Fdw, Gs^Efm, Wwr, Ww, Ww, Ww, Re, Gs^Wm, Re, Hh, Gs, Rrc, Rrc, Re^Ebn, Kh, Ww^Ewf, Rr^Vhc, Isr, Ch, Isr, Ch, Ww, Wo, Ds, Aa
Wo, Ww, Wo, Wo, Ww, Ww, Ds, Gs, Gs, Gs^Qhh, Gg^Qhh, Gg, Gg, Gs^Qhh, Gs^Dr, Gg^Qhh, Gg^Es, Gs, Re, Gs^Qhh, Gs^Efm, Gs, Re, Re, Re, Gs, Gs, Ds, Ww, Wo, Wo, Ww^Ewl, Rr^Efs, Rr, Rr, Rrc, Rr, Rr^Vhc, Wwr, Wo, Wo, Ww, Ww, Ch, Ww, Ww^Bw\, Wo, Ww, Gd^Fdf, Aa^Fpa
Wo, Wo, Ww, Wo^Wkf, Ww^Wkf, Ww^Wkf, Wwr, Ds, Ds, Gs^Qhh, Gs, Gg^Efm, Gg^Fdw, Gg^Fdw, Gs, Gg^Qhhf, Re, Re, Re, Rp, Re, Re, Gs^Fts, Gs, Gs^Fdw, Rr, Re, Gs, Rr, Ket, Rr^Efs, Wwr^Bw/, Ww, Ds, Ds, Ds, Wo, Wo, Wwr, Ww, Ds, Ww, Wo, Ww, Wo, Ww, Gs^Fdw, Ww, Ds, Gs
Wo, Wo^Wkf, Wo, Wo, Wo, Wwr, Ds, Ds, Gs, Ds, Gs, Gg^Efm, Gg, Gg^Fdw, Re, Gg, Re, Gg^Qhh, Gg^Es, Rr^Vhc, Gg, Gs^Fdw, Gs, Gd^Fts, Gs^Fdw, Gs, Gs, Rr, Gg, Rr, Rr^Vhc, Ket, Wo, Wwr, Ww, Ww, Ww, Ww, Ds, Ww^Ewl, Gd^Fdw, Ds, Ds, Wo, Ww, Ds, Gd, Gd, Gs^Fdw, Gs^Fdw
Wo, Wo, Wo, Wo, Ww, Wwr, Wwr^Wkf, Ds, Ds, Gs, Gg^Es, Gg^Efm, Ds, Gg, Re^Vl, Re, Gs^Fdw, Gg^Dr, Gg^Qhh, Gg, Gg^Fdw, Gs, Gd^Fdw, Ds, Re, Hh, Gg^Fts, Re, Rb^Gvs, Rb^Gvs, Re, Ww^Ewf, Ww, Wo, Wo, Wo, Ket, Ds, Gd^Fdw, Gd, Gs^Fdw, Aa, Ss, Ww, Ss, Gs^Fdw, Gd, Gs^Fdw, Gd^Fdf, Gd^Fdf
Wo, Wo, Wo^Wkf, Wo, Wo, Ww^Wkf, Ww, Wwr, Wwr, Ds, Gg^Fdw, Gg, Ds, Gs^Fdw, Gs^Fdw, Gs^Fdw, Gs^Qhhf, Gs^Qhh, Gg^Qhh, Gg, Ds, Gs, Ds, Gd, Re, Hh^Fts, Re, Re, Gg, Rb^Gvs, Gg, Re, Ds, Ww, Wo, Gs^Fdw, Gg^Es, Gd^Fdw, Aa, Gd, Aa, Aa, Gs, Gs^Fdw, Gd^Fdf, Gd^Fdf, Gd^Fdf, Gs^Fdw, Gs^Fdw, Gs^Fdw
Wo, Wo, Wo, Wo^Wkf, Ww^Wkf, Wo^Wkf, Ww, Ww^Wkf, Wwr, Ds, Ds, Gg^Efm, Gg, Gd, Gd^Fdw, Gd^Fdf, Gs, Gs^Qhhf, Gg, Ds, Gg^Qhh, Gd, Gg, Re, Gg^Es, Gg^Fts, Re, Gg, Ds, Hh, Gs, Gs, Ds, Ww, Ww^Ewf, Gd^Fdw, Gs, Gs, Gs^Fdw, Aa, Gd, Gs, Gg, Gs^Fdw, Gd^Fdf, Aa^Fpa, Gd^Fdf, Gd^Fdf, Gd^Fdf, Gd^Fdf
Wo, Wo, Wo, Wo^Wkf, Wo, Wo, Wo, Ww, Ww, Wwr, Ds, Gs, Gs^Efm, Gd, Ds, Gd^Fdw, Gg, Gg^Fdw, Gd, Gs^Qhh, Gg^Qhh, Gg^Dr, Gg^Fdw, Gg, Gg^Efm, Re, Gs^Qhh, Gg^Qhh, Ds, Gs, Re^Efm, Ds, Wwr, Wwr, Ww^Ewl, Gs, Aa, Gs^Efm, Gs, Gs, Re, Aa, Gs^Fdw, Gg, Gs, Aa, Aa^Fpa, Gd^Fdf, Aa^Fpa, Gd^Fdf
Wo, Wo, Wo, Wo, Wo, Ww, Ww, Ww^Wkf, Wo, Ww^Wkf, Ww, Ds, Ds, Gs, Gg, Ds, Gs, Gg^Fts, Ds, Ds, Gg, Gg, Gs^Fdw, Gs^Fdw, Re^Vl, Re, Ds, Gd, Gs^Efm, Gs, Re, Ww, Wo, Wwr, Ds, Ds, Gs^Fdw, Aa, Re, Rp, Aa, Aa, Aa, Gs^Fdw, Gs, Gs, Gs, Aa, Aa, Gd^Fdf
Wo, Wo, Wo, Wo, Wo, Ww, Wo, Ww, Ww, Ww^Wkf, Ww, Ww, Ww, Ds, Gg, Gg, Gs, Ds, Gs, Gs^Efm, Gg, Ket, Re, Gs, Re, Rp, Gd, Gs, Re, Re, Ww, Wo, Ww, Ds, Gd, Gd^Fdw, Aa, Aa, Rp, Gs^Es, Gs^Efm, Gd, Gd, Aa, Gd^Fdw, Gg, Gg, Aa^Fpa, Aa^Fpa, Aa^Fpa
Wo, Wo, Wo, Wo, Wo, Wo, Wo, Wo, Ww, Wo, Ww^Wkf, Ww, Ww^Bw\r, Gs, Re, Re^Efm, Re, Re, Re^Vh, Gg, Re, Re, Gg, Re, Gg, Ds, Gs, Re, Wwr, Wwr, Wo, Wo, Ww, Gs^Fdw, Ds, Gs, Re^Ve, Aa, Rp, Gd, Hhd, Gd^Fdw, Gg, Gd^Fdw, Gg, Gg, Gd, Gs, Gs, Aa
Wo, Wo, Wo, Wo, Wo, Wo, Wo, Wo, Wo, Wo, Ww^Wkf, Ww^Wkf, Ww, Re, Gs^Fdw, Gg, Gg, Gs^Fdw, Gs^Fdw, Re, Gs^Fdw, Gs^Qhh, Gd^Dr, Ket, Gg, Ds, Hhd^Fts, Re, Ds, Ww, Wo, Wo, Wo, Ww^Ewf, Ww, Gs^Ebn, Rrc, Rr, Gs, Gd, Hh^Fdw, Hhd, Hhd, Hh, Hh, Mm, Mm, Gd, Mm, Gs
Wo, Wo, Wo, Wo, Wo^Wkf, Wo, Wo, Wo, Ww, Wo^Wkf, Ww^Wkf, Ww^Bw\r, Re, Re, Ds, Gs^Fdw, Gs^Qhh, Gs^Fts, Gd, Re, Gs^Fts, Gs^Fdw, Gs^Qhh, Gg, Gg, Hhd, Hh, Gs^Fts, Ds, Ww^Ewl, Ww, Ww, Kh, Wo, Ww^Bsb/, Ww^Bsb/, Ww, Ds^Ebn, Hhd, Hh, Hhd^Fdw, Hhd, Mm, Hh^Fpa, Hh^Fpa, Hh, Hh, Mm, Hh^Fpa, Hh
Wo, Wo, Wo, Wo, Wo^Wkf, Wo^Wkf, Ww, Wo, Wwr, Ww, Ww, Ww, Re^Efm, Gd^Es, Ds, Gd^Fdw, Gs^Fts, Gs^Fdw, Gd, Re, Gg^Efm, Gg, Gg^Qhh, Gg^Qhh, Ds, Gg^Fts, Gg, Gs, Gs^Efm, Ds, Ch, Ch, Isr, Isr^Pr\o, Kh, Wwr, Ww, Gs^Fdw, Mm, Mm, Hhd, Mm, Mm, Mm, Mm, Hhd, Mm, Hh, Mm, Hh^Fpa
Wo, Wo, Wo, Wo^Wkf, Ww, Wo^Wkf, Ww, Ww, Wwr, Ds, Ds, Ds, Re, Ds, Gg^Efm, Gs^Fdw, Gd, Gd, Gs, Re, Gg, Gg, Gg, Gs, Gs, Gd, Ds, Ds, Gg, Ch, Isr, 3 Kh, Isr, Isr, Ch, Wo, Wo, Hh, Wwr, Mm, Ds, Hh^Fdw, Hh^Fdw, Mm, Mm, Hhd, Hhd^Fpa, Mm, Mm, Mm
Wo, Wo, Wo^Wkf, Wo, Wo, Wo, Wo, Ww^Wkf, Ww, Wwr, Ds, Gs, Re^Efm, Gg, Re^Gvs, Re^Gvs, Re^Gvs, Gs, Gg, Re, Rr, Gg^Efm, Rr, Rr, Re, Gg, Gg^Efm, Gg, Rrc^Vhc, Ch, Ch, Isr, Isr^Pr/o, Kh, Rrc, Ww, Ww^Ewl, Wwr, Ww, Ww, Ww, Ds, Gg, Mm, Gd, Hhd, Mm, Mm, Mm, Mm
Wo, Wo, Wo, Wo, Wo^Wkf, Wo^Wkf, Ww^Wkf, Ww, Ww^Wkf, Wwr, Ds, Ds, Re, Gs^Vh, Re, Re^Gvs, Gg^Es, Gs^Fdw, Gs^Fts, Gd^Fdw, Re, Rr, Gs^Fdw, Gs^Qhh, Gs^Fdw, Rrc, Rr, Rrc, Gs, Rrc, Rrc, Kh, Rrc, Rrc, Gs^Eff, Rrc^Vhc, Rrc, Wwr, Rr^Vhc, Wo, Wo, Ww^Ewf, Ww, Ds, Gd, Hh^Fdw, Mm, Mm, Wwr, Ww
Wo, Wo, Wo, Wo, Wo, Wo, Ww, Wo, Ww^Wkf, Wwr, Wwr, Ds, Gs, Re^Es, Chr, Gs, Rr, Gg, Rr, Re, Gs, Gs, Gs^Efm, Gs^Qhh, Gs^Qhh, Re, Gs, Gs^Fts, Gs, Gs, Gs, Rrc, Gs^Eff, Gs^Eff, Rb^Gvs, Rr^Eff, Gs^Eff, Rr, Re, Wwr, Ds, Ww, Wo, Ww, Ds, Hh^Fdw, Hh, Hhd, Wwr, Ww
Wo, Wo, Wo, Wo, Wo, Wo, Wo^Wkf, Ww, Ww^Wkf, Ww^Wkf, Wwr, Ds, Gs^Dr, Chr, 1 Khr, Chr, Rr^Dr, Rr, Gs, Rr, Gs, Gs^Es, Gs^Qhh, Gs^Dr, Gs, Re, Ket, Gs, Gs^Fts, Hh^Fts, Hh, Gs, Gs^Efm, Gs^Eff, Gs^Eff, Rb^Gvs, Gs^Eff, Gs^Efm, Re, Ds, Ds, Ds, Wwr, Wo, Ds, Ds, Wwr, Wwr, Ds, Ds
Wo, Wo, Wo, Wo, Wo, Wo, Ww, Wo, Ww^Wkf, Wwr, Ds, Ds, Gs, Chr, Chr, Chr, Rr, Gs, Re, Re, Gs^Wm, Gs^Efm, Gs^Fts, Gs^Fdw, Ds, Re, Re, Gd^Es, Ds, Hhd, Ds, Gs, Gs, Gs, Gs, Gs^Eff, Gs^Fdw, Gs^Es, Re, Gs, Gs, Ds, Ww, Wwr, Ww, Ww, Re, Ds, Gs, Gd^Fdw
Wo, Wo, Wo, Wo, Wo^Wkf, Wo, Wo, Wo, Ww, Wwr, Wwr^Wkf, Ds, Ds, Gs^Dr, Chr, Chr, Re, Gg^Efm, Re, Re^Vc, Gs, Gs^Fdw, Ds, Gd, Gs^Efm, Gd, Re, Gd, Gs, Ds, Gs, Gd, Ds, Gs^Fts, Gs, Gs^Fts, Gs^Fts, Re^Gvs, Re^Gvs, Re^Vh, Gs, Ds, Wwr, Ww, Wo, Ww, Gs^Fdw, Gs, Mm, Gd
Wo, Wo, Wo, Wo, Wo, Wo, Wo, Ww^Wkf, Ww, Ww^Wkf, Ww^Wkf, Wwr, Ds, Gs, Gs, Gs, Re^Vh, Re, Gg, Gg, Gs, Gd^Fdw, Ds, Gs^Dr, Gg^Qhh, Gs^Fdw, Re, Re^Vc, Gg, Gs^Efm, Gd^Fdw, Gs^Qhh, Gs^Qhh, Gs^Dr, Hh^Fts, Gs^Fts, Hh, Re^Gvs, Gs^Fts, Gd, Gs^Es, Ds, Ds, Ww, Ww, Ww, Gs, Hhd, Hh^Fdw, Hh
Wo, Wo, Wo, Wo, Wo, Wo^Wkf, Wo^Wkf, Wo, Wo^Wkf, Wo, Ww^Wkf, Wwr, Wwr, Ds, Gg, Gg, Gs, Gg^Efm, Gg^Efm, Gd^Es, Ds, Gd, Gs, Gg^Fdw, Gg^Qhh, Gg^Qhhf, Gg^Qhh, Gg, Gd, Gd^Fts, Gd^Qhh, Gd^Dr, Gd^Fts, Gs^Fts, Hh, Hh, Hh, Gll^Feth, Gs^Efm, Gd, Gd, Ds, Gs, Rr, Ww, Ww, Gg, Gd, Gd, Hhd^Fdw
Wo, Wo, Wo, Wo, Wo, Wo, Wo, Wo, Wo, Wo, Wo, Ww, Wwr, Ds, Ds, Ds, Gs, Gg^Fdw, Gg, Gd, Ds, Gs^Fdw, Gg, Gg^Qhh, Gg^Qhhf, Gg^Qhhf, Gg, Gg^Fdw, Gg, Gg^Qhh, Gg^Qhh, Gd^Qhh, Gd, Gd, Gs, Hh^Fts, Gs, Hh, Gs, Gs^Fdw, Gs, Gd, Gs, Rr, Ww, Wo, Gs, Mm, Mm, Mm
