Gs, Gs, Gs, Gs, Hh, Gs, Gs, Hh^Fp, Hh^Fp, Hh, Hh^Fp, Ss, Ss, Gs, Aa, Hh, Hh, Hh^Fdf, Ww, Mm, Mm, Mm, Mm, Hh, Mm, Hh, Mm, Mm, Mm, Hh, Mm, Hh, Gs^Emf, Aa, Re, Gs, Aa, Aa
Gs, Gs^Fdf, Gs^Fdf, Gs^Es, Gs^Es, Hh, Gs^Fp, Gs^Fp, Gs, Hh, Hh, Ss, Ss, Gs, Gs^Efm, Aa, Hh^Fp, Hh^Fp, Ww^Ewf, Mm, Mm, Mm, Hh, Mm, Mm, Mm, Ms, Mm, Mm, Hh, Hh, Hh, Gs^Es, Re^Vh, Re, Aa, Hh, Gs
Re, Gs^Efm, Gs^Fp, Re^Vh, Cv, Gs, Cv, Gs^Fp, Gs^Fp, Mm, Gs^Emf, Gs, Gs^Fp, Ss, Gs^Es, Aa, Ww^Ewl, Ww^Wkf, Hh, Hh, Hh, Hh, Hh, Hh, Hh, Ms, Ms, Ms, Mm, Mm, Mm, Gs^Efm, Ai, Re, Gs^Fdf, Hh, Hh, Gs
Gs^Efm, Re, Rp, Gs^Fp, Cv, 2 Kv, Cv, Rp, Rp, Hh^Vhh, Mm, Gs, Gs^Efm, Gs, Gs^Fp, Gs^Es, Wwr^Wkf, Mm, Hh, Hh, Gs^Efm, Hh, Gs^Efm, Hh, Mm, Mm, Mm, Mm, Hh, Hh, Mm, Mm, Hh, Re, Gs^Fp, Gs^Fdf, Mm, Mm
Aa, Gs^Es, Re, Gs^Fp, Gs^Ebn, Cv, Gs^Ebn, Gs^Fp, Re, Hh, Re, Hh, Ww, Wo^Ewf, Ww^Wkf, Wwr^Ewl, Gs, Gs, Gs^Efm, Gs, Hh^Efm, Hh, Mm, Hh^Fdf, Hh^Fdf, Mm, Hh, Hh, Hh, Hh, Gs, Hh, Sm^Gvs, Re, Re, Hh, Mm, Mm
Gs^Fdf, Aa, Aa, Rp, Rp, Rp, Gs^Fp, Gs^Efm, Aa, Rp, Gd^Es, Ww^Ewl, Gd, Ss, Ss, Gs^Efm, Mm, Mm, Hh, Hh, Hh^Efm, Mm, Mm, Mm, Hh, Hh^Fdf, Hh, Mm, Gs^Fp, Hh, Hh, Sm^Gvs, Gs^Eff, Re^Ve, Re, Gd, Mm, Mm
Hh, Mm, Re, Re, Gs^Fp, Re, Re, Gs^Efm, Gs^Efm, Re, Rp, Wwrt, Gs, Gs^Fp, Ss, Hh, Hh, Mm, Hh, Hh, Hh, Mm, Mm, Mm, Hh, Gs, Hh^Fdf, Gs, Mm, Mm, Mm, Gs^Eff, Re, Re, Gd, Gd^Efm, Hh^Fp, Hh
Hh^Fdf, Hh^Vhh, Gs^Emf, Gs^Fdf, Gs^Fdf, Gs, Gs^Fp, Re, Re, Gs^Es, Re, Ww^Bsb\, Rp^Efs, Gs^Fp, Gs^Fdf, Gs^Fdf, Gg, Hh, Hh, Hh, Mm, Hh, Mm, Mm, Hh^Efm, Hh, Hh^Fp, Mm, Hh^Es, Mm, Mm, Gs^Es, Re, Gs, Hh, Hh, Hh^Fdf, Gs^Fdf
Hh, Hh, Hh, Gs^Fp, Hh^Fdf, Gs^Fdf, Gs^Fdf, Gs, Ww^Wkf, Re, Ww^Ewl, Ww^Efs, Gs, Re, Re, Gs^Fp, Gg^Efm, Gs, Gd, Hh, Hh^Efm, Hh, Hh^Fp, Hh, Hh, Mm, Hh^Es, Hh, Mm, Mm, Aa, Re, Gd, Gd^Efm, Aa, Hh, Aa, Aa
Hh, Hh^Fp, Gg^Fp, Hh, Mm, Mm, Gg^Es, Gs^Fp, Wo^Ewf, Wwrt, Gs, Gd, Gs, Gs^Fp, Re, Gg, Gg^Efm, Gs, Gs, Hh, Hh, Hh^Fp, Mm, Hh, Hh, Hh, Mm, Mm, Mm, Aa, Aa, Re, Ai, Ai, Aa, Aa, Ww, Aa
Mm, Mm, Hh^Fp, Gg, Mm, Mm, Hh, Wo, Wo^Ewf, Ww^Wkf, Hh, Gs^Emf, Hh^Vhh, Re, Gs^Gvs, Re, Re, Gg^Es, Re, Gg^Ve, Gs^Fp, Hh^Fp, Hh, Hh, Hh, Hh, Mm, Mm, Mm, Aa, Gd, Re, Hh, Hh, Hh, Hh, Aa, Gd
Mm, Hh, Hh, Gg^Fp, Hh, Mm, Hh, Hh, Hh, Hh, Hh, Hh^Fp, Hh, Gs^Fdf, Gs^Gvs, Gs^Gvs, Gs^Es, Re, Gg^Efm, Gs, Ss, Hh, Hh, Hh, Hh, Mm, Mm, Mm, Gs, Gd, Re^Vh, Re, Re, Hh, Hh^Es, Hh^Efm, Aa, Gd
Mm, Mm, Mm, Hh, Hh, Gg^Es, Hh, Hh, Hh, Hh, Hh^Es, Hh^Es, Hh, Gs^Fdf, Gs^Fdf, Gs^Fp, Gs^Fp, Re, Re, Gs^Fp, Gs^Fp, Gs^Fp, Gs^Fdf, Gs^Fdf, Gs, Mm, Gs, Gs^Efm, Re, Re^Es, Gs, Gs^Emf, Hh^Fp, Re^Es, Re, Hh, Hh, Gd
Mm, Mm, Mm, Hh^Fp, Mm, Gg^Efm, Hh, Hh, Hh, Hh, Hh, Hh, Hh^Fp, Hh, Gg^Efm, Gs^Fdf, Gs^Wm, Gs, Re, Re, Re, Gs^Fdf, Gs^Es, Gs, Gs^Efm, Gs, Gg^Es, Re, Gs^Fp, Gs^Fp, Gs^Es, Hh, Hh^Fp, Hh, Re^Es, Hh^Efm, Mm, Hh
Mm, Mm, Mm, Hh, Ms, Mm, Mm, Hh^Es, Gg, Gg, Hh^Fp, Gg^Ve, Hh, Hh, Aa, Gg, Gg, Gs^Es, Re, Gd, Gs^Efm, Re, Re, Gs^Es, Gs, Gg^Efm, Re, Re, Hh, Hh, Hh^Fp, Hh, Mm, Hh, Mm, Re, Mm, Mm
Mm, Mm, Mm, Ms, Ms, Ms, Ms, Mm, Hh, Gg^Efm, Gg^Fp, Hh^Fp, Hh^Fp, Hh, Hh, Re^Ve, Re, Re, Gs^Fdf, Gs, Gs^Eff, Gs^Eff, Re^Eff, Re, Re, Re, Re^Ve, Hh, Gs, Hh, Hh^Fp, Mm, Hh^Fp, Gs, Mm, Hh^Vhh, Mm, Mm
Mm, Mm, Mm, Mm, Mm, Ms, Ms, Mm, Hh, Hh, Gg^Fp, Hh, Hh^Es, Hh, Aa, Ww, Aa, Gs^Fp, Gs^Fp, Gs^Fdf, Sm^Gvs, Sm^Gvs, Sm^Gvs, Re^Ve, Re, Gs^Efs, Gs^Gvs, Gs^Fp, Gs^Fp, Ss, Gs^Fp, Hh, Hh, Hh, Hh, Hh^Efm, Mm, Mm
Mm, Mm, Mm, Mm, Mm, Mm, Mm, Hh, Gg, Hh^Fp, Hh^Fp, Hh, Gg, Hh, Hh, Aa, Gs, Hh, Hh, Gs^Fp, Hh, Sm^Gvs, Gd^Eff, Gs^Eff, Gg, Re, Re, Gs, Gg^Efm, Gs^Fp, Gg, Hh, Gs^Emf, Gs, Hh^Es, Hh, Hh^Fp, Hh
Gs^Fp, Mm, Mm, Mm, Mm, Mm, Hh, Gg^Efm, Ss, Ss, Ss, Ss, Gs^Efm, Mm, Gs^Fp, Gs, Mm, Mm, Mm, Hh, Hh^Fp, Gs^Fp, Gs^Fp, Gs, Gg^Ve, Gg, Re, Gg, Gg, Gg^Es, Gs^Fp, Gg^Ve, Hh, Mm, Mm, Hh^Fp, Hh^Fp, Hh
Gs^Fp, Gs^Fp, Gs^Efm, Gs^Fp, Hh^Fp, Mm, Hh, Gg, Ss, Ss, Gs^Efm, Gs, Hh, Gs, Hh, Gs, Mm, Mm, Mm, Gs, Hh, Mm, Gs^Fp, Gs^Emf, Gs, Re, Rr, Gs^Fp, Gs, Gs^Es, Ss, Gs^Fp, Hh^Fp, Mm, Mm, Mm, Mm, Hh
Hh, Gs, Hh, Gs^Fp, Hh, Hh, Hh, Hh^Fp, Ss, Ss, Gs, Mm, Mm, Hh, Hh^Fp, Gs^Fp, Mm, Mm, Mm, Mm, Gs, Mm, Hh, Gs, Gs, Gg^Efm, Re, Gg, Gg, Gs^Fp, Ss, Gs^Fp, Hh^Es, Hh, Mm, Mm, Mm, Hh
Hh, Hh, Mm, Gs, Hh, Gg, Gg^Fp, Hh, Ss, Gs, Gs^Efm, Mm, Mm, Mm, Mm, Hh, Mm, Ww, Mm, Hh^Fp, Mm, Mm, Gs^Fp, Gs, Re, Rr, Gg^Efm, Gg, Ss, Ss, Gs^Fdf, Gs^Fp, Hh, Hh^Fp, Hh, Hh^Es, Mm, Mm
Hh, Mm, Gs, Gs^Efm, Gg, Gg^Fp, Hh^Fp, Hh^Efm, Hh, Hh^Fp, Hh, Gd, Gd, Mm, Mm, Hh, Mm, Ww^Ewl, Ww, Gs, Mm, Hh, Hh, Gs^Efm, Re, Gs, Gg, Gg, Gs, Gs^Fdf, Gs^Fp, Hh, Hh, Hh^Fp, Mm, Mm, Mm, Mm
Hh, Mm, Mm, Gs^Fp, Gs^Efm, Hh, Hh, Hh^Fp, Hh^Efm, Hh, Hh^Fp, Gs^Fdf, Gs^Fp, Mm, Mm, Hh^Fp, Mm, Mm, Mm, Wo^Wkf, Ww^Ewl, Hh, Gs^Fp, Gs, Rp, Gs, Gs^Fp, Gs^Fp, Gs^Fdf, Gs, Gs^Efm, Hh^Fp, Hh^Fp, Hh^Fp, Mm, Mm, Mm, Mm
Hh, Mm, Mm, Mm, Gs, Gs^Fp, Hh, Hh, Hh^Efm, Hh^Fp, Hh^Fp, Hh^Fdf, Gs^Fdf, Gs, Mm, Hh, Hh^Fp, Mm, Hh, Mm, Wwrt, Hh^Fp, Gs^Fp, Gs^Es, Re, Gs, Gg, Gs^Fdf, Gs^Fdf, Gg, Gs, Hh, Gs^Fp, Mm, Mm, Mm, Mm, Mm
Hh, Mm, Hh^Fp, Hh, Gs^Fdf, Gs^Fdf, Hh, Mm, Hh, Hh, Hh, Gs^Fdf, Gs^Fp, Gs, Mm, Mm, Hh, Hh^Vhh, Hh^Efs, Hh^Fp, Ww^Ewf, Hh, Gs^Fp, Gs^Vh, Rp, Gs^Es, Gg^Efm, Gg, Gs^Fdf, Gs^Fdf, Gs^Fdf, Gg, Gs^Fp, Hh, Mm, Mm, Hh, Hh^Fp
Hh^Fp, Hh^Fp, Hh^Fp, Hh, Gs^Fp, Hh^Fdf, Hh, Mm, Mm, Hh^Es, Gs, Gs^Fdf, Gd, Hh, Gg^Efm, Hh, Hh^Es, Gg^Emf, Hh^Fp, Hh, Wo^Wkf, Ww^Wkf, Ww, Gs, Rr, Gs, Chr, Gg, Rp, Rp^Ve, Sm^Gvs, Ss, Ss, Gs^Fp, Hh^Fp, Hh, Hh, Hh^Fp
Mm, Hh, Hh^Fp, Hh, Hh, Gs^Fp, Gs^Fp, Gs, Gs^Fp, Gd, Gd^Efm, Gd, Hh, Mm, Hh, Gg, Hh^Fp, Hh, Gg, Hh^Fp, Wo^Wkf, Wo^Ewl, Re, Re, Gs, Rp, 1 Khr, Chr, Gg^Eff, Sm^Gvs, Gs^Eff, Gs^Eff, Gs^Fp, Gs^Fp, Gs^Fp, Gs^Fp, Gs^Fp, Hh
Mm, Mm, Mm, Mm, Hh, Gs, Gs, Hh, Hh, Gs^Efm, Hh, Hh^Efm, Hh^Fp, Hh^Fp, Hh, Hh^Es, Hh^Fp, Hh, Hh^Fp, Wwrt, Gs^Fp, Wo, Re, Gs^Es, Gg, Chr, Chr, Chr, Chr, Gg^Eff, Gs^Efm, Gs^Efm, Gs, Gg^Es, Ss, Ss, Ss, Gs^Fp
Mm, Mm, Ms, Mm, Mm, Hh, Hh^Fp, Mm, Mm, Gs, Gs, Gs, Gs, Ss, Ss, Ss, Ss, Hh^Fp, Gs^Fp, Gs^Fdf, Ss, Wwrt^Ewf, Re, Gs, Gg, Gg, Gg^Es, Rp, Gg, Gg, Gg, Gg, Ww, Gs, Gg^Efm, Gs^Fdf, Gs^Fdf, Gs^Fp
Mm, Ms, Ms, Ms, Mm, Hh^Fp, Hh^Fp, Mm, Mm, Gs^Efm, Hh, Hh, Gs^Fp, Gg^Ve, Gs, Ss, Gs^Fp, Ss, Ss, Gs, Ww^Wkf, Wwrt, Re, Gs^Fdf, Gs^Fdf, Gs^Fdf, Gg, Rp^Ve, Hh, Hh^Fdf, Hh^Fp, Hh^Fdf, Ww, Gs^Es, Gs, Gg, Gs^Fdf, Ss
Mm, Mm, Mm, Mm, Mm, Hh, Hh, Hh, Hh, Hh, Hh, Mm, Gs^Fdf, Gs^Fdf, Gs, Gs^Fp, Gs, Ss, Gs, Gg, Ww, Gs, Re, Gs, Gs, Hh^Fp, Hh, Hh, Hh, Hh, Hh, Hh, Ww, Ww^Wkf, Gs, Gg^Es, Gs, Gs
