border_size=1
usage=map

Gs          , Gs          , Gs          , Gs          , Hh          , Gs          , Gs          , Hh^Fp       , Hh^Fp       , Hh          , Hh^Fp       , Ss          , Ss          , Gs          , Aa          , Hh          , Hh          , Hh^Fdf      , Hh          , Mm          , Mm          , Mm          , Mm          , Hh          , Mm          , Hh          , Mm          , Mm          , Mm          , Gs^Fp       , Gs          , Gs^Fp       , Gs          , Aa          , Gs          , Gs          , Aa          , Aa          
Gs          , Gs^Fdf      , Gs^Fdf      , Gs          , Gs          , Hh          , Gs^Fp       , Gs^Fp       , Gs          , Hh          , Hh          , Ss          , Ss          , Gs          , Gs          , Aa          , Hh^Fp       , Hh^Fp       , Hh          , Mm          , Mm          , Mm          , Hh          , Mm          , Mm          , Mm          , Mm          , Mm          , Mm          , Gs^Fp       , Gs^Fp       , Gs^Fp       , Gs          , Gs^Vh       , Gs          , Aa          , Gs^Fp       , Gs          
Re          , Gs          , Gs^Fp       , Gs^Vh       , Cv          , Gs          , Cv          , Gs^Fp       , Gs^Fp       , Mm          , Gs          , Gs          , Gs^Fp       , Ss          , Gs          , Aa          , Hh^Fp       , Hh          , Hh^Fp       , Hh          , Hh^Fp       , Hh          , Hh^Fp       , Hh          , Hh          , Mm          , Mm          , Mm          , Mm          , Mm          , Mm          , Gs          , Ai          , Gs          , Gs^Fdf      , Gs^Fp       , Gs^Fp       , Gs          
Gs          , Re          , Re          , Gs^Fp       , Cv          , 2 Kv        , Cv          , Gs          , Gs          , Hh^Vhh      , Mm          , Gs          , Gs          , Gs          , Gs^Fp       , Gs          , Gd          , Mm          , Hh          , Hh^Fp       , Hh          , Hh          , Hh          , Hh          , Mm          , Mm          , Mm          , Mm          , Hh          , Hh          , Mm          , Mm          , Hh          , Gs          , Gs^Fp       , Gs^Fdf      , Mm          , Mm          
Aa          , Gs          , Re          , Gs^Fp       , Gs          , Cv          , Gs^Fp       , Gs^Fp       , Re          , Hh          , Re          , Hh          , Gs          , Gs          , Gs          , Gs          , Gs          , Hh          , Hh          , Hh          , Hh          , Hh          , Mm          , Mm          , Mm          , Mm          , Hh          , Hh          , Hh          , Hh          , Hh          , Hh          , Gs          , Gs          , Gs          , Hh^Fp       , Mm          , Mm          
Gs^Fdf      , Aa          , Aa          , Re          , Re          , Gs^Fp       , Gs^Fp       , Gs          , Aa          , Re          , Gd          , Gs          , Gd          , Ss          , Ss          , Gs          , Mm          , Mm          , Hh          , Hh          , Hh          , Mm          , Mm          , Mm          , Hh          , Hh^Fdf      , Hh          , Mm          , Hh          , Hh          , Hh          , Hh          , Gs          , Gg^Ve       , Gd          , Gd          , Mm          , Mm          
Hh          , Mm          , Aa          , Gs          , Gs^Fp       , Re          , Re          , Gs          , Gs          , Re          , Re          , Gs          , Gs          , Gs^Fp       , Ss          , Hh^Fp       , Hh^Fp       , Mm          , Hh^Fp       , Hh^Fp       , Hh          , Mm          , Mm          , Mm          , Hh          , Hh          , Hh^Fdf      , Hh          , Mm          , Mm          , Mm          , Gs          , Gs          , Gs          , Gd          , Gd          , Hh          , Hh          
Hh^Fdf      , Hh^Vhh      , Gs          , Gs^Fdf      , Gs^Fdf      , Gs          , Gs^Fp       , Re          , Re          , Gs          , Re          , Re          , Re          , Gs^Fp       , Gs^Fdf      , Gs^Fdf      , Gg          , Hh^Fp       , Hh          , Hh^Fp       , Mm          , Hh          , Mm          , Mm          , Hh          , Hh          , Hh          , Mm          , Hh          , Mm          , Mm          , Gs          , Gs          , Gs          , Hh          , Hh          , Hh^Fdf      , Gs^Fdf      
Hh          , Hh          , Hh          , Gs^Fp       , Hh^Fdf      , Gs^Fdf      , Gs^Fdf      , Gs          , Gd          , Re          , Gd          , Gs          , Gs          , Re          , Re          , Gs^Fp       , Gg          , Gs          , Gd          , Hh          , Hh          , Hh          , Hh          , Hh          , Hh          , Mm          , Hh          , Hh          , Mm          , Mm          , Aa          , Gd          , Gd          , Gd          , Aa          , Hh          , Aa          , Aa          
Hh          , Hh^Fp       , Hh^Fp       , Hh^Fp       , Mm          , Mm          , Hh          , Gs^Fp       , Gs          , Gd          , Gs          , Gd          , Gs          , Gs^Fp       , Re          , Gg          , Gg          , Gs          , Gs          , Hh          , Hh          , Hh          , Mm          , Hh          , Hh^Fp       , Hh          , Mm          , Mm          , Mm          , Aa          , Aa          , Gd          , Ai          , Ai          , Aa          , Aa          , Ww          , Aa          
Mm          , Mm          , Hh^Fp       , Hh          , Mm          , Mm          , Hh          , Gs          , Gs          , Gs          , Hh          , Gs          , Hh^Vhh      , Gs          , Gs          , Re          , Re          , Gg          , Gs          , Gg^Ve       , Gs^Fp       , Hh          , Hh          , Hh^Fp       , Hh^Fp       , Hh          , Mm          , Mm          , Mm          , Aa          , Gd          , Gd          , Hh^Fp       , Hh^Fp       , Hh          , Hh          , Aa          , Gd          
Mm          , Hh          , Hh          , Hh^Fp       , Hh          , Mm          , Hh          , Hh          , Hh          , Hh^Fp       , Hh          , Hh^Fp       , Hh          , Gs^Fdf      , Gs          , Gs          , Gs          , Re          , Gg          , Gs          , Ss          , Hh          , Hh          , Hh^Fp       , Hh          , Mm          , Mm          , Mm          , Gs          , Gd          , Gs^Vh       , Gd          , Gd          , Hh^Fp       , Hh          , Hh          , Aa          , Gd          
Mm          , Mm          , Mm          , Hh          , Hh          , Hh          , Hh          , Hh^Fp       , Hh^Fp       , Hh^Fp       , Hh          , Hh          , Hh          , Gs^Fdf      , Gs^Fdf      , Gs^Fp       , Gs^Fp       , Re          , Re          , Gs^Fp       , Gs^Fp       , Gs^Fp       , Gs^Fdf      , Gs^Fdf      , Gs          , Mm          , Gs          , Gs          , Gs          , Gs          , Gs          , Gs          , Hh^Fp       , Hh          , Hh          , Hh          , Hh          , Gd          
Mm          , Mm          , Mm          , Hh^Fp       , Mm          , Hh          , Hh          , Hh          , Hh          , Hh          , Hh          , Hh          , Hh^Fp       , Hh          , Gg          , Gs^Fdf      , Gs          , Gs          , Gs          , Re          , Re          , Gs^Fdf      , Gs          , Gs          , Gs          , Gs          , Gg          , Gg          , Hh          , Hh          , Gs          , Hh          , Hh^Fp       , Hh          , Hh          , Hh          , Mm          , Hh          
Mm          , Mm          , Mm          , Hh          , Mm          , Mm          , Mm          , Hh          , Hh          , Hh          , Hh^Fp       , Gg^Ve       , Hh          , Hh          , Aa          , Gg          , Gg          , Gs          , Gs          , Gd          , Gs          , Re          , Re          , Gs          , Gs          , Gg          , Re          , Re          , Hh          , Hh          , Hh          , Hh          , Mm          , Hh          , Mm          , Mm          , Mm          , Mm          
Mm          , Mm          , Mm          , Mm          , Mm          , Mm          , Mm          , Mm          , Hh          , Hh          , Hh^Fp       , Hh^Fp       , Hh^Fp       , Hh          , Hh          , Gg^Ve       , Gg          , Gs          , Gs^Fdf      , Gs          , Gs^Fdf      , Gs          , Gs^Vh       , Re          , Re          , Re          , Gg^Ve       , Hh          , Gs          , Hh          , Hh          , Mm          , Hh          , Hh          , Mm          , Hh^Vhh      , Mm          , Mm          
Mm          , Mm          , Mm          , Mm          , Mm          , Mm          , Mm          , Mm          , Hh          , Hh          , Hh^Fp       , Hh          , Hh          , Hh          , Aa          , Ww          , Aa          , Gs^Fp       , Gs^Fp       , Gs^Fdf      , Gd          , Gs          , Gs          , Gs          , Re          , Gs          , Gs          , Gs^Fp       , Gs^Fp       , Ss          , Gs^Fp       , Hh          , Hh          , Hh          , Hh          , Hh          , Mm          , Mm          
Mm          , Mm          , Mm          , Mm          , Mm          , Mm          , Mm          , Hh          , Hh          , Hh^Fp       , Hh^Fp       , Hh          , Hh          , Hh          , Hh          , Aa          , Gs          , Hh          , Hh          , Gs^Fp       , Hh          , Gd          , Gd          , Gs          , Gg          , Re          , Re          , Gs          , Gg          , Gs^Fp       , Gg          , Hh          , Hh          , Hh          , Hh          , Hh          , Hh          , Hh          
Gs^Fp       , Mm          , Mm          , Mm          , Mm          , Mm          , Hh          , Hh          , Ss          , Ss          , Ss          , Ss          , Gs          , Mm          , Gs^Fp       , Gs          , Mm          , Mm          , Mm          , Hh          , Hh          , Gs^Fp       , Gs^Fp       , Gs          , Gg^Ve       , Gg          , Re          , Gg          , Gg          , Gg          , Gs^Fp       , Gg^Ve       , Hh          , Mm          , Mm          , Hh          , Hh          , Hh          
Gs^Fp       , Gs^Fp       , Gs          , Gs          , Hh          , Mm          , Hh          , Hh          , Ss          , Ss          , Gs          , Gs          , Hh          , Gs          , Hh          , Gs          , Mm          , Mm          , Mm          , Hh          , Hh          , Mm          , Hh          , Gs          , Gs          , Gg          , Rr          , Gs^Fp       , Gs          , Gs          , Ss          , Gs^Fp       , Hh^Fp       , Mm          , Mm          , Mm          , Mm          , Hh          
Hh          , Gs          , Hh          , Gs          , Hh          , Hh          , Hh          , Hh^Fp       , Ss          , Ss          , Gs          , Mm          , Mm          , Hh          , Hh          , Hh          , Mm          , Mm          , Mm          , Mm          , Hh          , Mm          , Hh          , Gs          , Gs          , Gg          , Re          , Gg          , Gg          , Gs^Fp       , Ss          , Gs^Fp       , Hh          , Hh          , Mm          , Mm          , Mm          , Hh          
Hh          , Hh          , Mm          , Gs          , Hh          , Hh          , Hh          , Hh          , Ss          , Gs          , Gs          , Mm          , Mm          , Mm          , Mm          , Hh          , Mm          , Mm          , Mm          , Hh          , Mm          , Mm          , Hh          , Gs          , Re          , Rr          , Gg          , Gg          , Ss          , Ss          , Gs^Fdf      , Gs^Fp       , Hh          , Hh^Fp       , Hh          , Hh          , Mm          , Mm          
Hh          , Mm          , Gs          , Gs          , Hh          , Hh          , Hh^Fp       , Hh          , Hh          , Hh^Fp       , Hh          , Gd          , Gd          , Mm          , Mm          , Hh          , Mm          , Mm          , Hh          , Hh          , Mm          , Hh          , Hh          , Gs          , Re          , Gs          , Gg          , Gg          , Gs          , Gs^Fdf      , Gs^Fp       , Hh          , Hh          , Hh          , Mm          , Mm          , Mm          , Mm          
Hh          , Mm          , Mm          , Gs          , Gs          , Hh          , Hh          , Hh^Fp       , Hh          , Hh          , Hh^Fp       , Gs^Fdf      , Gs^Fp       , Mm          , Mm          , Hh          , Mm          , Mm          , Mm          , Hh          , Hh          , Hh          , Gs^Fp       , Gs          , Re          , Gs          , Gs^Fp       , Gs^Fp       , Gs^Fdf      , Gs          , Gs          , Hh^Fp       , Hh^Fp       , Hh^Fp       , Mm          , Mm          , Mm          , Mm          
Hh          , Mm          , Mm          , Mm          , Gs          , Gs^Fp       , Hh          , Hh          , Hh          , Hh^Fp       , Hh^Fp       , Hh^Fdf      , Gs^Fdf      , Gs          , Mm          , Hh          , Hh          , Mm          , Hh          , Mm          , Hh          , Hh          , Gs^Fp       , Gs          , Re          , Gs          , Gg          , Gs^Fdf      , Gs^Fdf      , Gg          , Gs          , Hh          , Gs^Fp       , Mm          , Mm          , Mm          , Mm          , Mm          
Hh          , Mm          , Hh          , Hh          , Gs^Fdf      , Gs^Fdf      , Hh          , Mm          , Hh          , Hh          , Hh          , Gs^Fdf      , Gs^Fp       , Gs          , Mm          , Mm          , Hh          , Hh^Vhh      , Hh          , Hh          , Hh          , Hh          , Gs^Fp       , Gs^Vh       , Re          , Gs          , Gg          , Gg          , Gs^Fdf      , Gs^Fdf      , Gs^Fdf      , Gg          , Gs^Fp       , Hh          , Mm          , Mm          , Hh          , Hh^Fp       
Hh          , Hh          , Hh          , Hh          , Gs^Fp       , Hh^Fdf      , Hh          , Mm          , Mm          , Hh          , Gs          , Gs^Fdf      , Gd          , Hh          , Hh          , Hh          , Hh          , Hh          , Hh^Fp       , Hh          , Ww          , Ww          , Gs          , Gs          , Rr          , Gs          , Chr         , Gg          , Gg          , Gg^Ve       , Gs          , Ss          , Ss          , Gs^Fp       , Hh^Fp       , Hh          , Hh          , Hh^Fp       
Mm          , Hh          , Hh          , Hh          , Hh          , Gs^Fp       , Gs^Fp       , Gs          , Gs          , Gd          , Gd          , Gd          , Hh          , Mm          , Hh          , Hh          , Hh^Fp       , Hh          , Hh          , Hh^Fp       , Ww          , Gg          , Re          , Re          , Gs          , Gg          , 1 Khr       , Chr         , Gg          , Gg          , Gs^Fp       , Gs^Fp       , Gs^Fp       , Gs^Fp       , Gs^Fp       , Gs^Fp       , Gs^Fp       , Hh          
Mm          , Mm          , Mm          , Mm          , Hh          , Gs          , Gs          , Hh          , Hh          , Gs          , Hh          , Hh          , Hh          , Hh          , Hh          , Hh          , Hh^Fp       , Hh          , Hh^Fp       , Hh          , Gs^Fp       , Gg          , Re          , Gs          , Gg          , Chr         , Chr         , Chr         , Chr         , Gg          , Gs          , Gs          , Gs          , Gg          , Ss          , Ss          , Ss          , Gs^Fp       
Mm          , Mm          , Mm          , Mm          , Mm          , Hh          , Hh          , Mm          , Mm          , Gs          , Gs          , Gs          , Gs          , Ss          , Ss          , Ss          , Ss          , Hh^Fp       , Gs^Fp       , Gs^Fdf      , Ss          , Gg          , Re          , Gs          , Gg          , Gg          , Gg          , Gg          , Gg          , Gg          , Gg          , Gg          , Ww          , Gs          , Gg          , Gs^Fdf      , Gs^Fdf      , Gs^Fp       
Mm          , Mm          , Mm          , Mm          , Mm          , Hh          , Hh          , Mm          , Mm          , Gs          , Hh          , Hh          , Gs^Fp       , Gg^Ve       , Gs          , Ss          , Gs^Fp       , Ss          , Ss          , Gs          , Gs          , Gs          , Re          , Gs^Fdf      , Gs^Fdf      , Gs^Fdf      , Gg          , Gg^Ve       , Hh          , Hh^Fdf      , Hh^Fp       , Hh^Fdf      , Ww          , Gs          , Gs          , Gg          , Gs^Fdf      , Ss          
Mm          , Mm          , Mm          , Mm          , Mm          , Hh          , Hh          , Hh          , Hh          , Hh          , Hh          , Mm          , Gs^Fdf      , Gs^Fdf      , Gs          , Gs^Fp       , Gs          , Ss          , Gs          , Gg          , Gg          , Gs          , Re          , Gs          , Gs          , Hh^Fp       , Hh          , Hh          , Hh          , Hh          , Hh          , Hh          , Ww          , Ww          , Gs          , Gg          , Gs          , Gs          
