Gg, Gg, Gs, Gg, Gg^Fmf, Gg, Gg, Gg, Hh^Fmf, Hh, Hh, Hh, Hh^Fmf, Gg, Gs^Efm, Gg, Gs, Gg, Gg, Gg^Fmf, Gg, Gg, Gg, Hh, Hh, Gg, Gg^Fdf, Gg^Fmf, Hh^Fmf, Hh, Hh, Gg, Gg^Efm, Gg^Fmf, Gs, Gg, Gg, Hh, Gs, Gg, Gg, Ss, Ss, Ss, Ss, Gg, Ss, Ss, Ww, Ww
Gg^Fmf, Gg, Re^Vh, Gg^Efm, Gg, Gg^Es, Gg^Fmf, Gg^Fmf, Gg^Efm, Gg, Hh^Fmf, Hh, Hh^Fet, Hh, Hh^Fdf, Gg^Fmf, Hh, Gg^Fmf, Re^Vh, Gg^Fmf, Gg^Fmf, Hh, Hh^Fmf, Hh^Fmf, Re, Re, Re, Gg^Fdf, Re, Re, Re, Gg^Fmf, Re, Re, Re, Gg^Efm, Ds, Ds, Ds, Gg^Efm, Ww, Ww^Ewf, Ww^Wkf, Ss, Ww, Ss, Ww^Ewl, Ww^Wkf, Wo^Wkf, Wo
Gg^Fmf, Gs, Gg^Efm, Re, Chr, Chr, Chr, Gg^Fmf, Gg, Hh, Gg^Fmf, Gg^Fdf, Gg^Fdf, Gg^Efm, Hh, Gg^Fmf, Gg^Fdf, Gs^Es, Re, Gg, Re, Gs^Es, Hh, Gg^Fmf, Re, Re^Vh, Gg^Es, Re, Ss, Ss, Ww, Re, Ww, Ds, Ds, Ds^Vh, Ww^Ewl, Ww, Ww, Wwr, Gg^Fmf, Ww, Gg^Fmf, Ww, Wo, Ww, Wo, Wo, Ww^Ewl, Ww
Gg, Gg^Fmf, Gg^Fdf, Isa, Chr, 1 Khr, Chr, Chr, Gg^Fmf, Gg^Es, Isa, Gg^Efm, Gg^Vh, Gg, Re, Re, Isa, Re, Gg^Fmf, Re, Hh^Efm, Re, Re, Re, Gs, Hh, Ds, Gg^Efm, Ww^Wkf, Ww^Ewf, Wwr, Wwr, Hh, Ww, Ww^Wkf, Ww, Wo, Ww, Wo, Wwr, Gg^Efm, Hh, Ww, Wo, Ww, Wo^Wkf, Ww^Wkf, Wo, Ww, Ss
Gg^Fmf, Gg^Fdf, Gg^Efm, Gg, Re, Chr, Isa, Re, Isa, Isa, Gg^Fmf, Isa, Re, Isa, Gs, Hh, Gg^Efm, Hh, Gg, Gg^Efm, Ds, Gs^Es, Re, Gg^Efm, Ss, Gg^Es, Ww^Ewl, Ww^Wkf, Hh, Gg, Hh^Fmf, Gg^Fmf, Wo, Wo, Wo, Wo, Ww^Wkf, Wo^Wkf, Ww, Wo, Ww, Wwr, Wwr, Ww^Wkf, Ww^Ewl, Ww, Ss, Ww, Ss, Gg
Hh, Hh, Hh, Hh^Fmf, Isa, Isa, Gs, Isa, Gg^Fmf, Hh, Gs, Gg, Hh, Gg^Es, Ds, Hh, Gg^Es, Gg^Efm, Ds, Ds, Ww^Ewl, Gg^Efm, Isa, Gg^Fmf, Ww^Wkf, Ww^Wkf, Ww, Wo, Gg, Hh, Wwr, Wo, Ww^Ewl, Ww^Ewl, Ww^Wkf, Wo, Ww, Ww^Wkf, Ww^Ewf, Ww, Ss, Gg, Gg, Re^Vh, Re, Ds, Gg, Ss, Hh, Gg
Gg, Hh^Fmf, Hh, Hh, Re, Hh, Gg, Gs^Efm, Gg, Gg^Es, Gg, Gg^Efm, Gs, Ds, Ww^Ewl, Gg, Ww, Ds, Wwr, Ww, Ww^Wkf, Wwf^Wkf, Ww^Bsb|, Wwr^Ewf, Wo, Wo, Wo, Wo, Ww, Wwr, Gg^Fmf, Ww^Wkf, Ds, Ss, Ss, Ww, Ww^Wkf, Ss, Ss, Ss, Gg^Fmf, Gg^Es, Gg^Fmf, Gg, Re, Gg^Efm, Hh^Fmf, Gg, Gg^Fmf, Gg
Gg^Fmf, Gg^Es, Gs, Re, Hh, Gg, Gg, Gs^Efm, Gg^Es, Ds, Ww, Ds, Ww^Wkf, Ww^Wkf, Ww, Ww^Ewf, Ww, Wwr, Wwr, Wwr, Ww, Wwr, Gg, Wwr, Wo, Ww, Ww^Wkf, Ww, Ww^Wkf, Gg, Gg^Efm, Gg, Hh, Gg, Gg, Ww, Wo, Ds, Gg^Fmf, Gg, Gg^Es, Hh^Fmf, Gg, Gg^Efm, Re, Gs, Gg^Fmf, Gg^Fdf, Gg^Fdf, Gg
Gg^Fmf, Hh, Re^Vh, Re, Gs, Gg, Ss, Gg, Wwf^Wkf, Ww^Ewf, Ww, Ww, Wo, Wo, Wo, Wo, Wo^Wkf, Ww, Gg^Efm, Gg^Fmf, Gg^Vh, Hh, Hh, Ww, Ww, Ww^Wkf, Ss, Ww^Ewf, Ss, Ds, Hh, Hh^Fmf, Hh, Gg^Fmf, Gg, Hh, Ww^Ewf, Hh, Hh, Hh, Hh^Fmf, Hh, Gs, Re, Gg^Es, Gg, Gg^Eff, Gg, Hh^Fmf, Gg
Gg, Gg^Efm, Gg^Fmf, Re, Ss, Ss, Ww^Ewl, Gg, Wwf, Wwf, Hh^Fmf, Wo, Ww, Wo^Wkf, Wo, Ww, Ww^Wkf, Ww, Wwr, Hh, Gg^Fmf, Gg^Efm, Gg, Gg^Fmf, Wwr, Ww^Ewl, Ds, Ss, Hh, Gg, Gg^Es, Gg^Fmf, Gg^Efm, Gg, Gg, Gg^Fmf, Wo, Hh, Ds, Hh, Gg, Gg^Fmf, Gg^Eb, Isa, Ch, Gg^Eff, Sm^Gvs, Gg^Eff, Gg^Eff, Hh
Gg, Gs^Es, Gg^Es, Gg, Ww^Wkf, Ww^Ewf, Ww, Ww, Wo, Gg, Wwr, Wwf, Ww^Wkf, Ww^Wkf, Ww, Ww, Ww^Ewf, Wwr, Wwr, Wwr, Ww^Wkf, Wwf^Wkf, Ww^Bsb|, Ww, Ww^Wkf, Ds, Gg, Gg^Fmf, Gg^Eff, Gg^Eff, Gg^Eff, Gg, Re, Re^Vh, Gg^Fmf, Ss, Ww, Ww, Gg, Gg, Gs^Es, Gg, Isa^Qhh, Ch, 4 Kh, Ch, Gg, Gg^Eff, Gs^Efm, Gg
Hh^Fmf, Hh^Fmf, Ds, Gs, Ww^Ewf, Ww^Wkf, Wo, Wo, Wo^Wkf, Wo, Wwr, Wwr, Gg, Ds, Gg, Ss, Ss, Gg, Gg^Efm, Ww, Ww^Ewl, Ww, Isa, Wwf^Wkf, Gs, Ds, Gg^Eff, Gg^Eff, Sm^Gvs, Sm^Gvs, Kh, Gg^Efm, Gg^Es, Re, Gg, Gg, Ds, Ww^Wkf, Wo, Hh, Isa, Isa, Gg^Eb, Ch, Ch, Ch, Gg, Gg^Es, Hh^Fmf, Hh
Gg, Gg^Efm, Ds, Wwr, Gg^Fmf, Wo, Wo^Wkf, Ww, Ww, Ww^Wkf, Ww^Ewf, Gg, Gg, Gs^Efm, Gg^Fmf, Ss, Gg, Gs, Gg, Gg, Hh, Gg, Isa, Gg, Gg^Efm, Gs, Gg^Es, Gg^Eff, Ce, Ce, Urb^Qhu, Ce, Ce, Re, Gg^Fmf, Gg^Es, Gg, Ww^Ewl, Ww, Ss, Isa, Gg, Gs, Gg, Isa, Gs, Gg, Hh^Fmf, Gg^Fdf, Hh
Ds, Ds, Ww^Wkf, Wwr, Hh, Wwr, Wwr, Ww^Wkf, Ww^Ewl, Ww, Ds, Gs^Es, Gg^Es, Hh, Gs^Efm, Hh, Hh, Gg^Es, Gs^Efm, Gg^Fmf, Gg^Fdf, Gg, Gg^Fmf, Isa, Isa, Gg^Fmf, Gg^Fdf, Kh, Urb^Qhu, Urb^Qhu, Ch, Urb^Qhu, Urb^Qhu, Kh, Gg, Gs, Gg^Efm, Ds, Isa, Ww^Bw/, Ww^Ewf, Gg^Es, Ds, Gg, Re, Gg^Fmf, Gg, Gg^Fdf, Gg^Efm, Gg^Fmf
Ww, Ww^Ewl, Wo, Wo, Ww, Wwr, Gg, Gs^Efm, Gg, Ds, Hh, Gg, Re^Vh, Gg, Gg^Fmf, Gs, Hh, Hh, Gg, Hh, Gg^Fmf, Gg, Gs, Gg^Es, Isa, Isa, Isa, Isa^Efs, Urb^Qhu, Ch, 2 Kh, Ch, Urb^Qhu, Ce, Isa, Gs, Isa, Gg, Isa, Gg, Ds, Ww, Wo, Gg^Efm, Gg^Es, Re, Re, Gg, Gg, Gg^Fmf
Wo^Wkf, Wo^Wkf, Ww, Ww^Wkf, Ww^Wkf, Ww^Ewl, Ds, Gg, Hh, Hh^Fmf, Gg^Fmf, Gg^Fdf, Re, Re, Hh, Gg, Gg^Efm, Hh, Gg^Es, Gg^Efm, Gg, Gg^Fmf, Gg, Isa, Gg^Efm, Gs, Gg, Ce^Efs, Urb^Qhu, Ch, Ch, Ch, Urb^Qhu, Isa^Efs, Gg, Isa, Gg, Isa, Gg, Gg, Gg^Wm, Ww^Wkf, Ww, Ss, Hh, Gg, Re, Re^Vh, Gs^Efm, Gg
Wo, Wo, Ww^Ewf, Gg, Gg^Es, Ds, Hh, Gs^Efm, Gg, Hh, Hh, Hh^Fmf, Gg^Fmf, Re, Isa, Ch, Ch, Gg, Isa, Gs, Isa, Gg^Es, Isa, Isa, Gs^Efm, Gg, Gg^Eff, Kh, Ce, Urb^Qhu, Urb^Qhu, Urb^Qhu, Ce, Kh^Efs, Gg, Re, Gg, Gs^Efm, Gg, Gg^Fmf, Gg, Gg, Ss, Ww^Ewl, Ww^Wkf, Ds, Gg, Gg^Es, Gg^Fdf, Gg
Ww, Ww, Re, Re^Vh, Re, Gg^Efm, Gg, Gg^Es, Hh, Hh^Fmf, Hh, Gg^Wm, Hh, Gg^Efm, Gg^Ebn, Ch, 3 Kh, Isa^Qhu, Gg, Isa, Gg^Eff, Isa, Re, Gg, Gg, Gg^Eff, Gg^Eff, Sm^Gvs, Sm^Gvs, Ce, Kh, Ce, Gg, Gs, Re, Re, Hh, Gg, Gg, Hh, Gg^Fmf, Hh^Fmf, Hh, Wo, Wo, Hh, Hh^Fmf, Gg^Fmf, Gg^Fdf, Gg^Fmf
Gg, Ds, Gg, Gg^Efm, Gg, Re, Hh, Hh, Gg, Hh, Gs, Gg^Es, Re, Re, Re, Isa^Qhu, Ch, Ch, Gg^Eff, Gg^Eff, Sm^Gvs, Gg^Eff, Gg^Eff, Re, Hh, Gg^Fmf, Gg^Fmf, Gg^Eff, Gg^Efm, Gg^Eff, Gg, Gg, Gg^Es, Gg, Re, Hh, Gg, Hh, Gg^Fmf, Gg^Fet, Gg^Fdf, Gg^Fdf, Hh^Fmf, Hh, Ww^Ewf, Hh, Hh^Fmf, Hh, Mm, Gg
Gg, Gg^Fdf, Hh, Gs, Hh, Re, Hh, Gg^Fmf, Gg^Fmf, Gg^Efm, Re, Re, Gs, Gg^Efm, Gg^Fmf, Gg^Ebn, Gg, Ch, Gs, Gg^Eff, Hh^Fmf, Gg^Eff, Gg^Es, Re, Gg^Es, Gg, Hh, Hh, Gg, Gs, Gg^Fmf, Hh, Gg^Fdf, Gg^Fmf, Gg^Fdf, Re, Re, Re, Gg, Gg^Fmf, Hh^Fmf, Hh, Hh, Hh^Fmf, Ww, Hh, Gg, Hh, Mm, Mm
Gg, Hh^Fmf, Hh^Fdf, Gg, Gs^Efm, Re, Re, Gg^Es, Re, Gg, Re, Hh, Gg^Es, Gg^Fmf, Gg^Fdf, Hh, Hh, Gg^Efm, Gg^Fmf, Gg, Gs, Gg^Efm, Re, Re, Gg^Efm, Gg, Hh, Gg^Fmf, Hh, Gg, Hh, Gg^Fmf, Hh^Fmf, Hh, Hh, Gg^Fmf, Gg^Efm, Re^Vh, Gg^Efm, Hh, Hh^Fmf, Mm, Hh, Hh, Ww, Wo, Hh, Hh^Fmf, Hh, Mm
Gg, Hh^Fmf, Hh, Gg^Es, Gg^Fmf, Gg, Gg^Fmf, Re, Gg, Re^Vh, Re, Gg^Efm, Hh, Hh, Gg^Fmf, Gg^Fmf, Hh, Gs, Hh^Fmf, Gg^Fet, Hh, Gg^Fmf, Gg, Re^Vh, Gg, Hh^Fmf, Hh, Gg^Efm, Hh, Gg^Es, Gg^Fmf, Hh, Hh, Hh, Mm, Hh, Hh^Fmf, Gg, Hh, Hh, Mm, Mm, Mm, Hh, Hh, Ww^Wkf, Ww^Ewl, Hh, Hh^Fmf, Gg
Gg, Hh^Fmf, Gg^Es, Hh, Hh^Es, Gg^Fdf, Gg^Fmf, Hh, Gg^Fmf, Gg^Efm, Gg^Es, Gs, Hh, Gg^Fdf, Gg^Fmf, Hh, Hh^Fmf, Gg, Hh, Hh^Fmf, Hh, Gg, Hh^Fmf, Gg^Efm, Hh, Hh^Fmf, Mm, Hh, Mm, Hh^Fmf, Hh, Hh, Mm, Mm, Mm, Hh, Hh^Fmf, Gg^Es, Hh, Hh, Mm, Mm, Mm, Mm, Mm, Hh, Hh, Ww^Wkf, Hh, Hh^Fmf
Gg, Hh, Hh, Hh, Gg, Gg^Fdf, Gg, Gg, Gg, Gg, Gg, Hh^Fmf, Gg, Gg, Gg, Gg, Gg, Hh, Gg, Hh^Fmf, Gg, Gg, Gg, Hh, Gg, Mm, Gg, Mm, Gg, Gg^Es, Hh, Mm, Gg, Mm, Gg, Mm, Gg, Hh, Gg, Mm, Gg, Mm, Gg, Mm, Gg, Mm, Gg, Ww, Gg, Gg
