Gs^Fp, Gs^Fp, Gs^Fp, Gs^Fp, Gs^Fp, Gs^Fp, Gg^Es, Gg, Hh, Gs^Fp, Gs^Fp, Gs^Fp, Gs^Fp, Gs^Fp, Gs^Fp, Gg, Gg, Gg, Gg, Gg, Gs^Fp, Gs^Fp, Gs^Fp, Gg, Gg, Gg, Gg, Ss, Ss, Ww, Ww^Wkf, Wot, Wot, Ww, Dd, Gg, Gg, Gs^Fp, Gs^Fp, Gs^Fp, Gg^Fp, Gg, Hh, Gg, Hh, Gs^Fp, Gg, Isa
Gs^Fp, Hh^Fp, Hh^Fp, Gg^Efm, Gs, Gd, Hh, Gg, Gs^Fp, Hh^Fp, Gg, Gs^Fp, Gs^Fp, Gg, Gg^Efm, Gg, Gs, Co, Co, Gd^Dr, Gg^Dr, Hh, Gg^Es, Hh^Es, Gs, Gg, Hh, Gg, Ss, Ss, Ww^Ewf, Wot, Wot^Wkf, Ww^Wkf, Wwr^Ewl, Gs^Fp, Gs^Fp, Gg, Gg, Gg, Rb^Vo, Hh, Hh^Es, Gg, Hh, Gd, Rb, Isa
Gs^Fp, Gs^Fp, Gs^Fp, Hh^Fp, Gs^Fp, Gs^Fp, Rb^Vo, Gs^Fetd, Gs^Fp, Gs^Fp, Gs^Fms, Hh^Fp, Rb, Rb, Isa, Isa, Co, 2 Ko, Gs, Gd^Dr, Hh, Hh, Gg^Fp, Gs^Fetd, Hh, Gg^Fp, Gg^Efm, Gg, Gg, Gs^Fp, Dd, Ww, Wot, Ww, Ww^Ewf, Dd, Gg, Gs^Fp, Gg^Fetd, Gg^Fp, Hh, Gg^Fp, Gg^Fp, Hh^Es, Isa, Isa, Gd, Gg
Gs^Fp, Hh^Fp, Gs^Fetd, Gs^Fp, Hh, Gs^Fp, Rb, Rb, Rb, Rb, Rb, Rb, Gs^Fms, Gs^Fp, Gg, Rb^Vo, Gd^Ecf, Co, Isa, Gd, Gg, Hh^Es, Hh, Gg^Efm, Hh, Gg^Fp, Hh, Gs, Gs^Fms, Gs^Fms, Dd, Ww^Wkf, Wot, Ww, Ss, Dd, Gg, Gg^Fds, Gg, Hh, Gs, Hh, Isa, Rb, Gg^Dr, Gg^Dr, Gs^Fp, Gs^Fp
Gg, Gg^Es, Hh^Es, Hh^Fp, Rb, Rb, Gs^Fms, Gs^Fms, Gg^Efm, Gs^Fp, Dd, Dd, Dd, Gs^Fp, Ss, Gg^Efm, Gg, Gs, Gg^Efm, Isa, Hh, Gg^Fms, Rb, Rb, Rb^Vo, Gg, Gg^Fds, Gg, Gg^Efm, Gs^Fp, Ww^Ewl, Wwr, Wot, Ww^Wkf, Ss^Ewf, Ss, Ss, Ss, Gg^Efm, Gg, Hh, Isa, Hh, Rb, Co, Co, Co, Gs^Fp
Gs^Fp, Hh^Fp, Hh^Fp, Gg^Es, Rb, Gs^Fp, Gs^Fms, Dd, Ww^Wkf, Ww^Ewf, Ww, Wwr^Wkf, Ww^Ewl, Gs^Fp, Ss, Ss, Gg, Gg, Hh, Rb, Isa, Hh, Rb, Gg^Fds, Rb, Hh, Gg, Gg, Dd, Dd, Wot^Wkf, Ww^Wkf, Wot, Wwr^Wkf, Dd, Ss, Gs^Fp, Gs^Fp, Gg, Gg^Fp, Gg, Rb, Gg, Gd^Ecf, Co, 5 Ko, Co, Gs^Fp
Gs^Fp, Gg^Efm, Gs^Fp, Gs^Fp, Rb, Gs^Fp, Gs^Fp, Dd, Dd, Wwr, Ww^Wkf, Ww, Wot^Wkf, Ww^Ewl, Wwr, Dd^Wkf, Ww, Dd, Dd, Gg, Gg, Rb, Gg^Fds, Gg^Fds, Dd, Dd, Ww^Ewl, Gg, Ww, Ww^Ewf, Wot, Wot, Ww^Wkf, Ww^Ewf, Gs^Fp, Gg, Gs^Fp, Rb^Vo, Rb, Hh, Rb, Isa, Rb, Isa, Isa, Co, Gg^Dr, Gs^Fp
Gs^Fp, Gs^Fp, Gs^Fp, Gs^Fp, Rb, Hh^Fp, Ss, Ss, Ss, Ww^Ewl, Wot, Wot, Wot, Wot, Wwr, Ww^Wkf, Ww^Wkf, Ww^Ewl, Ww^Ewf, Ss, Gs, Hh, Gg, Gg^Efm, Wwr^Wkf, Ww^Ewf, Ww^Wkf, Wwr, Wot, Wot, Ww^Wkf, Ww, Dd, Gs^Fp, Gs^Fms, Gs^Fms, Rb, Rb, Gg, Rb, Gg, Gg^Fp, Gg^Es, Isa, Rb, Co, Gg, Gs^Fp
Gs^Fp, Gs^Fp, Gg^Vo, Rb^Es, Gs^Fp, Gs^Fp, Gs^Fp, Gs^Fms, Gs^Fp, Dd, Ww^Ewf, Wot^Wkf, Ww^Wkf, Wot, Wot, Wot^Wkf, Wot, Ww, Wwr, Gg^Efm, Gg, Gg, Ww^Ewl, Wwr, Wot, Wwr, Wwr, Wwr, Wwr^Ewf, Wwr, Ww^Wkf, Wwr^Wkf, Dd, Gs^Fms, Rb, Rb, Gs^Fp, Gs^Fp, Gs^Fp, Gg, Hh, Hh, Hh, Gg, Rb, Gd, Gg^Efm, Gg
Gs^Fp, Gs^Fp, Gg^Efm, Rb, Isa, Gs^Fp, Co, Gs^Dr, Gg^Ecf, Gg, Dd, Ww, Ww^Wkf, Wot, Wot, Wot, Wot, Ww^Wkf, Ww^Wkf, Dd, Dd, Dd, Wwr, Ww, Wot, Wwr, Ww^Ewl, Ww, Gg, Wwr^Ewl, Gs^Fp, Dd, Gs^Fms, Gs^Fms, Rb, Gg^Efm, Hh, Gs^Fp, Gg^Fetd, Hh^Es, Gg, Gg, Hh, Rb, Hh, Hh, Hh, Hh
Gg, Gg, Gs^Fp, Gs^Fetd, Isa^Fp, Gs, 3 Ko, Co, Gs^Fms, Gs^Fp, Gs^Fp, Dd, Ww, Wot, Ww^Wkf, Wot, Wot^Wkf, Ww^Wkf, Ww, Ww^Ewl, Dd, Dd, Ww, Wot, Ww^Wkf, Wwr^Wkf, Gs^Fp, Ss, Gg, Ss, Gs^Fp, Rb^Vo, Rb, Rb, Gs^Fms, Gs^Fp, Gs^Fp, Gs, Gg, Gs^Efm, Gg, Ss, Ss, Rb^Es, Hh, Gg, Hh^Fp, Gg
Gg, Gs^Fp, Gg, Gs^Fp, Isa, Co, Co, Gs^Eff, Gg^Eff, Gg^Vo, Gg^Eff, Wwr, Ww^Ewf, Ww^Wkf, Gg, Wwr, Ww^Wkf, Ww^Wkf, Dd, Dd, Ww^Wkf, Ww, Wot, Wot, Ww^Ewf, Dd, Gs^Fms, Gs^Fms, Rb, Ss, Isa, Rb, Gs^Fms, Gs^Fp, Gs^Fp, Gs^Fp, Hh, Gg^Efm, Gg, Gg, Ww^Ewl, Ss, Gg, Rb, Rb^Vo, Hh, Hh, Gg
Gs^Fp, Gg^Es, Gs, Gg^Efm, Gg, Isa, Isa, Gg^Dr, Gs, Gg^Eff, Gg^Efm, Dd, Dd, Dd, Gg^Efm, Ww^Ewl, Dd, Dd, Dd, Dd, Ww, Ww^Wkf, Wot, Ww, Gs^Fp, Gs^Fms, Gg^Efm, Gs^Fds, Gs^Fp, Rb, Rb, Hh, Gs^Fp, Gs^Fp, Gs^Fetd, Gg, Gg^Fp, Gg, Ss, Ss, Ww, Ww^Wkf, Ss, Gg, Rb, Hh, Gg^Es, Gg
Gs^Fp, Gs^Fp, Gg, Gg^Es, Hh, Gg^Efm, Gs, Rb, Rb, Gg^Fds, Gg, Gg, Gg, Hh, Gg, Dd, Gg^Fms, Gg, Dd, Ww^Wkf, Wot^Wkf, Wot, Ww^Wkf, Ww^Ewl, Gs^Fp, Gg^Fds, Gg, Gd, Gs^Fp, Gs^Fp, Isa, Hh^Fp, Gg, Gs^Fp, Gs^Fp, Gg^Efm, Gg, Dd, Ww^Ewf, Ww^Wkf, Wot, Ww, Ww^Ewf, Ss, Gg^Efm, Rb, Rb^Es, Gs^Fp
Gs^Fp, Gs^Fp, Gs^Fp, Gs^Fp, Hh^Es, Gg, Gg^Fp, Hh, Gg, Rb^Es, Rb, Gg^Fds, Gg, Hh^Efm, Gs^Fp, Gg, Gg, Gg, Ww^Ewf, Ww, Wot, Ww, Dd, Dd, Gg, Gg, Gs^Fp, Gs^Fp, Gs, Gs^Fp, Isa, Isa, Rb^Vo, Rb, Rb, Gs^Fp, Gg^Fetd, Dd, Ww^Wkf, Ww, Wot^Wkf, Wot, Ww, Ss, Dd, Gg^Fp, Rb^Es, Gs^Fp
Gs^Fp, Gg, Gs^Fp, Gs^Fp, Hh, Gg, Hh, Gg^Es, Gs^Efm, Rb, Hh, Rb^Es, Rb, Gg, Gg^Fds, Gs^Fp, Gs^Fms, Dd, Wwr, Wot^Wkf, Wot, Ww, Ww^Ewl, Gs^Fp, Gs^Fp, Gs^Fp, Gg^Efm, Co, 4 Ko, Co, Rb, Gg, Hh, Gs^Fp, Rb, Gd^Fp, Rb^Es, Gg, Ss, Ww, Ww^Wkf, Wot, Ww, Ww^Wkf, Ss, Rb, Gd, Gg
Gg, Gs^Fp, Gg, Gg, Gs^Fp, Gg^Fp, Gg, Gg, Rb, Rb, Hh, Gg^Fp, Gg, Rb, Rb, Gg, Gg^Fetd, Gs^Fms, Gs^Fp, Ww^Wkf, Wwr, Wot, Wot^Wkf, Dd, Gs^Fp, Gg, Gg, Co, Isa, Co, Gg, Hh, Hh^Fp, Gs^Fp, Gg, Rb, Gg, Rb, Rb, Ss, Ss, Ww^Wkf, Ww^Ewl, Ww^Wkf, Rb, Rb, Gs, Gs^Fp
Gg, Hh, Gs^Fp, Gs^Fp, Gg^Feth, Gs^Fp, Gs^Fp, Gs^Fp, Rb, Gs, Gg, Hh, Gs^Fp, Hh, Rb, Gg^Es, Gs, Gs^Fp, Gs^Fp, Ww^Ewl, Wwr, Wot, Wot, Wot^Wkf, Ww^Ewf, Gd, Gg, Gg, Isa, Gg^Ecf, Gd, Gg, Gg^Efm, Gs^Fp, Gs^Fp, Hh^Fp, Hh^Fp, Gs^Fp, Rb, Ss, Gg, Gg^Efm, Rb, Rb, Gs^Fp, Gg^Efm, Gs^Fp, Gs^Fp
Gs^Fp, Gs^Fp, Hh^Fp, Gg^Efm, Gg, Gd, Gg, Gg, Cvr, Gg, Gs^Fp, Gs^Fp, Gs^Fp, Hh^Fp, Gs^Efm, Rb, Rb^Vo, Gg, Ss, Ss, Dd, Ww^Wkf, Ww, Wot, Ww, Wwr, Dd, Gg, Gd, Isa, Hh^Fp, Gg, Gs^Fp, Gd^Fp, Gs^Fp, Hh^Fp, Gs^Fp, Gs^Fp, Hh^Fp, Rb, Rb^Vo, Rb, Gs, Gg^Efm, Gg, Gs^Fp, Gs^Fp, Gs^Fp
Gs^Fp, Gs^Fp, Hh^Fp, Hh, Rb^Es, Gs, Gg^Efm, Cvr, 1 Kvr, Cvr, Gs^Dr, Hh^Fp, Hh^Fp, Gg, Gg, Gg^Fp, Gg, Gg, Ss, Ss, Dd, Ww^Ewl, Ww^Wkf, Wot^Wkf, Wot, Ww, Ww^Wkf, Dd, Gg^Vo, Rb^Es, Hh, Gg, Hh^Fp, Hh^Fp, Gs^Fp, Gg, Gg, Hh^Fp, Gg, Gs^Fp, Gs^Fp, Gs^Fp, Gs^Fp, Hh, Gg, Gs^Fp, Gg, Gs^Fp
Gs^Fp, Hh^Fp, Gs^Fp, Rb^Vo, Gs, Rb^Es, Rb, Cvr, Cvr, Cvr, Gs^Dr, Gs^Fp, Gs^Fp, Hh, Hh, Gg^Fetd, Gs^Efm, Ss, Gg, Gg, Gs^Fp, Dd, Gg^Efm, Ww, Ww, Wot^Wkf, Ww^Wkf, Ww^Ewl, Gg, Isa, Rb, Gs^Fp, Gs^Fp, Gs^Fp, Hh^Fp, Gs^Fp, Gd, Gd^Efm, Gs^Fp, Gs^Fp, Hh^Fp, Gs^Fp, Hh, Gg^Efm, Gg, Hh, Gs^Fp, Gg
Gs^Fp, Gs^Fp, Gg, Gs^Fp, Gg, Gg^Efm, Gg, Gg^Eb, Gg, Gs^Fp, Gs^Fp, Gs^Fp, Gs^Fp, Hh^Fp, Gs^Fp, Gg, Gg, Gg, Gg, Gg^Es, Gg, Gg, Gg, Ww^Ewf, Ww, Wot, Ww, Ww^Wkf, Gg, Gs^Fp, Gs^Fp, Rb, Gs^Fp, Gs^Fp, Gs^Fp, Hh^Fp, Gg, Gg, Gs^Fp, Gs^Fp, Gg, Gg, Gg, Gs^Fp, Gs^Fp, Gs^Fp, Gs^Fp, Gs^Fp
