Wwb, Wwb, Wwb, Wwb, Wwb, Wwb, Wwb, Wwb, Wwb, Wwb, Wwb, Wwb, Wwb, Wwb, Wwb, Wwb, Wwb, Wwb, Wwb, Wwb, Wwb, Wwb, Wwb, Wwb, Wwb, Wwb, Wwb, Wwb, Wwb, Wwb, Wwb, Wwb, Wwb, Wwb, Wwb, Wwb, Wwb, Wwb, Wwb, Wwb, Wwb, Wwb, Gd, Gs^Ft, Gs^Ft, Rd, Rr, Re^Vht, Gs^Gvs, Gg^Gvs
Wwb, Wwb, Wwb, Wwb, Wwb, Wwb, Wwb, Wwb, Wwb, Wwb, Wwb, Wwb, Wwb, Wwb, Wwb, Wwb, Wwb, Wwb, Wwb, Wwb, Wwb, Wwb, Wwb, Wwb, Wwb, Wwb, Wwb, Wwb, Wwb, Wwb, Wwb, Wwb, Wwb, Wwb, Wwb, Wwb, Wwb, Wwb, Wwb, Wwb, Wwb, Wwb, Ds, Gg, Gs^Ft, Rd, Rr, Gs, Re^Vht, Gs
Wwb, Wwb, Wwb, Wwb, Wwb, Wwb, Wwb, Wwb, Wwb, Wwb, Wwb, Wwb, Wwb, Wwb, Wwb, Wwb, Wwb, Wwb, Wwb, Wwb, Wwb, Wwb, Wwb, Wwb, Wwb, Wwb, Wwb, Wwb, Wwb, Wwb, Wwb, Wwb, Wwb, Wwb, Wwb, Wwb, Wwb, Wwb, Wwb, Wwb, Wwb, Wwb, Ds^Ewsh, Gg, Chr, Chr, Chr, Rr, Rr, Gs
Wwb, Wwb, Wwb, Wwb, Wwb, Wwb, Wwb, Wwb, Wwb, Wwb, Wwb, Wwb, Wwb, Wwb, Wwb, Wwb, Wwb, Wwb, Wwb, Wwb, Wwb, Wwb, Wwb, Wwb, Wwb, Wwb, Wwb, Wwb, Wwb, Wwb, Wwb, Wwb, Wwb, Wwb, Wwb, Wwb, Wwb, Wwb, Wwb, Wwb, Wwb, Wwb, Wwb, Ds, Wwb, Khr, Chr, Gs^Efm, Gd, Rr
Wwb, Wwb, Wwb, Wwb, Wwb, Wwb, Wwb, Wwb, Wwb, Wwb, Wwb, Wwb, Wwb, Wwb, Wwb, Wwb, Wwb, Wwb, Wwb, Wwb, Wwb, Wwb, Wwb, Wwb, Wwb, Wwb, Wwb, Wwb, Wwb, Wwb, Wwb, Wwb, Wwb, Wwb, Wwb, Wwb, Wwb, Wwb, Wwb, Wwb, Wwb, Wwb, Wwb, Ds, Gs, Chr, Gll, Gll, Gll^Fts, Rr
Wwb, Wwb, Wwb, Wwb, Wwb, Wwb, Wwb, Wwb, Wwb, Wwb, Wwb, Wwb, Wwb, Wwb, Wwb, Wwb, Wwb, Wwb, Ds, Wwb, Wwb, Wwb, Wwb, Wwb, Wwb, Wwb, Wwb, Wwb, Wwb, Wwb, Wwb, Wwb, Wwb, Wwb, Wwb, Wwb, Wwb, Wwb, Wwb, Wwb, Wwb, Wwb, Wwb, Ds, Ds^Ewsh, Gll^Fts, Gll^Fts, Gg^Efm, Gs^Gvs, Rr
Wwb, Wwb, Wwb, Wwb, Wwb, Wwb, Wwb, Ds, Wwb, Ds, Ds, Wwb, Ds, Ds, Wwb, Wwb, Wwb, Ds, Ds, Wwb, Wwb, Wwb, Wwb, Wwb, Wwb, Wwb, Wwb, Wwb, Wwb, Wwb, Wwb, Wwb, Wwb, Wwb, Wwb, Wwb, Wwb, Wwb, Wwb, Wwb, Wwb, Wwb, Wwb, Wwb, Ds, Gll^Fts, Hh^Ft, Gg^Gvs, Rr^Vht, Rr
Wwb, Wwb, Wwb, Wwb, Wwb, Wwb, Wwb, Wwb, Ds, Ds, Ds, Wwb, Wwb, Ds, Wwb, Wwb, Wwb, Wwb, Ds, Wwb, Ds, Ds, Ds, Wwb, Wwb, Wwb, Wwb, Wwb, Wwb, Wwb, Wwb, Wwb, Wwb, Wwb, Wwb, Wwb, Wwb, Wwb, Wwb, Wwb, Wwb, Wwb, Wwb, Wwb, Wwb, Hh, Hh, Gll^Fts, Gs^Eff, Re
Ds, Wwb, Ds, Wwb, Wwb, Wwb, Ds, Wwb, Wwb, Ds, Wwb, Wwb, Ds, Wwb, Wwb, Wwb, Wwb, Ds, Ds, Ds, Ds, Ds, Ds, Ds, Wwb, Ds, Wwb, Wwb, Wwb, Wwb, Wwb, Wwb, Wwb, Wwb, Wwb, Wwb, Wwb, Wwb, Wwb, Wwb, Wwb, Wwb, Wwb, Wwb, Wwb, Wwb, Wwb, Gs^Eff, Gs^Eff, Rr
Wwb, Ds, Ds, Ds, Ds, Wwb, Ds, Ds, Ds, Wwb, Ds, Wwb, Wwb, Ds, Wwb, Wwb, Wwb, Wwb, Ds, 1 Wwbf, Ds, Ds, Ds, Ds, Ds, Wwb, Wwb, Wwb, Wwb, Wwb, Wwb, Wwb, Wwb, Wwb, Wwb, Wwb, Wwb, Wwb, Wwb, Wwb, Wwb, Wwb, Wwb, Wwb, Wwb, Wwb, Wwb, Wwb, Wwb, Re
Wwb, Wwb, Wwb, Ds, Wwb, Ds, Wwb, Wwb, Ds, Ds, Ds, Ds, Wwb, Ds, Ds, Wwb, Wwb, Wwb, Wwb, Ds, Wwb, Ds, Ds, Ds, Ds, Ds, Wwb, Ds, Wwb, Wwb, Wwb, Wwb, Wwb, Wwb, Wwb, Wwb, Wwb, Wwb, Wwb, Wwb, Wwb, Wwb, Wwb, Wwb, Wwb, Wwb, Wwb, Wwb, Wwb, Wwb
Wwb, Wwb, Wwb, Wwb, Wwb, Wwb, Wwb, Wwb, Ds, Ds, Wwb, Wwb, Ds, Ds, Ds, Wwb, Wwb, Wwb, Wwb, Wwb, Ds, Ds, Ds, Wwb, Wwb, Ds, Ds, Wwb, Wwb, Wwb, Wwb, Wwb, Wwb, Wwb, Wwb, Wwb, Wwb, Wwb, Wwb, Wwb, Wwb, Wwb, Wwb, Wwb, Wwb, Wwb, Wwb, Wwb, Wwb, Wwb
Wwb, Wwb, Wwb, Wwb, Wwb, Wwb, Wwb, Wwb, Wwb, Wwb, Wwb, Wwb, Ds, Ds, Wwb, Wwb, Wwb, Wwb, Wwb, Wwb, Wwb, Ds, Wwb, Wwb, Wwb, Wwb, Wwb, Wwb, Wwb, Wwb, Wwb, Wwb, Wwb, Wwb, Wwb, Wwb, Wwb, Wwb, Wwb, Wwb, Wwb, Wwb, Wwb, Wwb, Wwb, Wwb, Wwb, Wwb, Wwb, Wwb
Wwb, Wwb, Wwb, Wwb, Wwb, Wwb, Wwb, Wwb, Wwb, Wwb, Wwb, Wwb, Wwb, Ds, Wwb, Ds, Wwb, Wwb, Wwb, Wwb, Wwb, Wwb, Wwb, Wwb, Wwb, Wwb, Wwb, Wwb, Wwb, Wwb, Wwb, Wwb, Wwb, Wwb, Wwb, Wwb, Wwb, Wwb, Wwb, Wwb, Wwb, Wwb, Wwb, Wwb, Wwb, Wwb, Wwb, Wwb, Wwb, Wwb
Wwb, Wwb, Wwb, Wwb, Wwb, Wwb, Wwb, Wwb, Wwb, Wwb, Wwb, Wwb, Wwb, Wwb, Wwb, Wwb, Wwb, Wwb, Wwb, Wwb, Wwb, Wwb, Wwb, Wwb, Wwb, Wwb, Wwb, Wwb, Wwb, Wwb, Wwb, Wwb, Wwb, Wwb, Wwb, Wwb, Wwb, Wwb, Wwb, Wwb, Wwb, Wwb, Wwb, Wwb, Wwb, Wwb, Wwb, Wwb, Wwb, Wwb
Wwb, Wwb, Wwb, Wwb, Wwb, Wwb, Wwb, Wwb, Wwb, Wwb, Wwb, Wwb, Wwb, Wwb, Wwb, Wwb, Wwb, Wwb, Wwb, Wwb, Wwb, Wwb, Wwb, Wwb, Wwb, Wwb, Wwb, Wwb, Wwb, Wwb, Wwb, Wwb, Wwb, Wwb, Wwb, Wwb, Wwb, Wwb, Wwb, Wwb, Wwb, Wwb, Wwb, Wwb, Wwb, Wwb, Wwb, Wwb, Wwb, Wwb
Wwb, Wwb, Wwb, Wwb, Wwb, Wwb, Wwb, Wwb, Wwb, Wwb, Wwb, Wwb, Wwb, Wwb, Wwb, Wwb, Wwb, Wwb, Wwb, Wwb, Wwb, Wwb, Wwb, Wwb, Wwb, Wwb, Wwb, Wwb, Wwb, Wwb, Wwb, Wwb, Wwb, Wwb, Wwb, Wwb, Wwb, Wwb, Wwb, Wwb, Wwb, Wwb, Wwb, Wwb, Wwb, Wwb, Wwb, Wwb, Wwb, Wwb
Wwb, Wwb, Wwb, Wwb, Wwb, Wwb, Wwb, Wwb, Wwb, Wwb, Wwb, Wwb, Wwb, Wwb, Wwb, Wwb, Wwb, Wwb, Wwb, Wwb, Wwb, Wwb, Wwb, Wwb, Wwb, Wwb, Wwb, Wwb, Wwb, Wwb, Wwb, Wwb, Wwb, Wwb, Wwb, Wwb, Wwb, Wwb, Wwb, Wwb, Wwb, Wwb, Wwb, Wwb, Wwb, Wwb, Wwb, Wwb, Wwb, Wwb
Wwb, Wwb, Wwb, Wwb, Wwb, Wwb, Wwb, Wwb, Wwb, Wwb, Wwb, Wwb, Wwb, Wwb, Wwb, Wwb, Wwb, Wwb, Wwb, Wwb, Wwb, Wwb, Wwb, Wwb, Wwb, Wwb, Wwb, Wwb, Wwb, Wwb, Wwb, Wwb, Wwb, Wwb, Wwb, Wwb, Wwb, Wwb, Wwb, Wwb, Wwb, Wwb, Wwb, Wwb, Wwb, Wwb, Wwb, Wwb, Wwb, Wwb
